BBBBBBBBBBB
BGGGGGGGGGB
BG0GGGGGGGD
BGGGGGGGpGD
BGGGGGGGGGB
BGGGGGGGGGB
BBBBBBBBBBB