BBBBBBBBBBBBBBBBBBBBBBBBBBBBBBBBBBBBBBBB********************************
BGGGGGGGGGGGGGGGGGGGGGGGGGGGGGGGGGGBBBBBBBBBBBBBBBBB********************
BGGSGGGGGGGGGGGGGGGGGGGGGGGGGGGGGGGGGGGGGGGGGGGGGGGGBBBBBBBBBB**********
BGGGGGGBBBBBBBBBGGGGGGGGGGGGGGGGGGGGGGGGGGGGGGGGGGGGGGGGGGGGGB**********
BGGGGGGBGGGGGGGBGGGGGGGGGGGGGGGGBBBBBBBBBBBBBGGGGGGGGGGGSGGGGB**********
BGGGGGGBGGGSGGGBBBBBBBBBBGGGGGGGGBGGGGGGGGGGGBGGGGGGGGGGGGGGGB**********
BGGGGGGBGGGGGGGGGGGGGGGGBGGGGGGGGGBGGGGSGGGGGGBBBBBBBGGGGGGGGGBBBBBBBBBB
BGGGGGGBGGGGGGGGGGGGGGGGBGGGGGGGGGGBGGGGGGGGGGGGGGGGBGGGGGGGGBGGGGGGGGGB
BGGGGGGBBBBBBBBGGGGGGGGGGBGGGGGGGGGGBGGGGGGGGGSGGGGGBGGGGGGGGBGGGGGGGGGB
BGGGGGGGGGGGGGGBGGGGGGGGGGBGGGGGGGGGBGGGGBBBBBBBBBBBBGGGGGGGBGGGGbGGGGGB
*BGGGGGGGGGpGGGBGGGGGGGGGGGGGGGGGGGGBGGGGGGGGGGGGGGGGGGGGGGGSGGGGGGGGGGB
**BBBBBBBBBBBBBBBBBGGGGGGGGGGGGGGGGGBGGGGGGGGGGGGGGGGGGGGGGGGGGGGGGGGPGB
*******************BBBBBBBBBBBBBBBBBBBBBBBBBBBBBBBBBBBBBBBBBBBBBBBBBBBB*
