GGGGGGGTGGTGTGTGGTGTGTGTGTGGTGTGTGGTGTGTGTGGTGTGTGTGGTGTGTGGTGTGGTGTGTGGTGTGGTGTTGGTGGGGGG
GGGGGGGGTGGGGTGTGTGTGTGTGTGTGTGTGTGTGTGTGTGTGTGTGTGTGTGTGTGTGTGTGTGGTGTGGTTGTGTGTGTGGGGGGG
GGGGGGGTGGTGTGTGGTGTGTGTGTGGTGTGTGGTGTGTGTGGTGTGTGTGGTGTGTGGTGTGGTGTGTGGTGTGGTGTTGGTGGGGGG
GGGGGGGTGGTGTGTGGTGTGTGTGTGGTGTGTGGTGTGTGTGGTGTGTGTGGTGTGTGGTGTGGTGTGTGGTGTGGTGTTGGTGGGGGG
GGGGGGGGTGGGGTGTGTGTGTGTGTGTGTGTGTGTGTGTGTGTGTGTGTGTGTGTGTGTGTGTGTGGTGTGGTTGTGTGTGTGGGGGGG
GGGGGGGTGGTGTGTGGTGTGTGTGTGGTGTGTGGTGTGTGTGGTGTGTGTGGTGTGTGGTGTGGTGTGTGGTGTGGTGTTGGTGGGGGG
GGGGGGGGTGGGGTGTGTGTGTGTGTGTGTGTGTGTGTGTGTGTGTGTGTGTGTGTGTGTGTGTGTGGTGTGGTTGTGTGTGTGGGGGGG
GGGGGGGGGTGTTGGTGTGTGTGGTGTGTGTGGTGTGTGGTGTGTGTGTGGTGTGGTGTGTGGTGTGTGGTGTGTGTGGTGGGGTGGGGG
GGGGGGGGTGGTGGGGGGGGGGGGGGGGGGGGGGGGGGGGGGGGGGGGGGGGGGGGGGGGGGGGGGGGGGGGGGGGGGGTGGTGGTGGGG
GGGGGGGGGTGGGGGGGGGGGGGGGGGGGGGGGGGGGGGGGGGGGGGGGGGGGGGGGGGGGGGGGGGGGGGGGGGGGGTGTGGTGGTGGG
GGGGGGGGGTTGGGGGGGSGGGGGGGGGGGGGGGSGGGGGGGSGGGGGGGGGGGGSGGGGGGGGSGGGGGGGGGGGGGGTGTGGTGGTGG
GGGGGGGGGGGTGGGGGSGGGGGGGGGGGGGGGGGGGGGGGGGGGGGGGGGGGGGGGGGGGGGGGGGGGGGSGGGGGTGGTGTGGGGGGG
GGGGGGTGGTGTGGGGGGGGGGGGGGGGGGGGGGGGGGGGGGGGGGGGGGGGGGGGGGGGGGGGGGGGGGGGGGGGGGTGGTGTGTTGGG
GGGGGGGTGGGTGGGGGGGGGGGTGGTGTGGTGTGTGGTGTGTGGTGTGTGTGTGTGGTTGGTGTGTGGGGGGGGGGGGTGGTGTGGGGG
GGGGGGGGTTGGTGGGGGGGGGGGTGTGTGTGTGGTTGGTGTGGTGTGTGTGTGGTGTGTGTGGTGTGTGGGGGGGGGTGGTGTGGGTGG
GGGGGGGGGGTTGGGGGSGGGGGTGGGGGGGGGGGGGGGGGGGGGGGGGGGGGGGGGGGGGGGGGGGTGGGGGGGGGGGTTGGGGTGGGG
GGGGGGGTGTGGTGGGGGGGGGGGGTGGGGGGGGGGGGGGGGGGGGGGGGGGGGGGGGGGGGGGGGTGTGGGGGGGGGGTGTTGGGTGGG
GGGGGGGGGGTTGGGGGGGGGGGTGGGGGGGGGGGGGGGGGGGGGGGGGGGGGGGGGGGGGGGGGTGTGGGGGGGGGGGTGGTGGGGTGG
GGGGGGGTGGTGTGGGGSGGGGGGTGGGGGGSGGGGGGGSGGGGGGGGGGGGGGGGGGbGGGGGGGTGGGGGGGGGGGGGGGGTGGGGGG
GGGGGGGGTTGTGGGGGGGGGGGTGGGGGGGGGGGGGGGGGGGGGGGGGGGGGGGGGGGGGGGGGTGGGGGGGSGGGGGTGGTGGTTGGG
GGGGGGGGGTTGGGGGGGGGGGGGTGGGGGGGGGGGGGGGGGGGGGGGGGGGGGGGGGGGGGGGGGTGGGGGGGGGGGTGGTGGGGGGGG
GGGGGGGTGGGTGGGGGGGGGGGTGGGGGGGGGGGGGGGGTGTGGTGTGTGGTGTGTGTGTGGTTTGGGGGGGGGGGGGGGGGGGGGTGG
GGGGGGGTGGTTGGGGGGGGGTGGTGGGGGSGGGGGGGGGGTGGTGTGTGGTGTGTGTGGTGTGTTTGGGGGGGGGGGGGGTTTGGTGGG
GGGGGGGTGGGGGGGGGGGGGGGTGGGGGGGGGGGGGGGGGGGGGGGGGGGGGGGGGGGGGGGGGGTGGGGGGGGGGGGTGTGGTGGGGG
GGGGGGGGTGTGGGGGpGGGGGGGGGGGGGGGGGGGGGGGGGGGGGGGGGGGGGGGGGGGGGGGGGGGGGGGGSGGGGGGGGGGGGGGGG
GGGGGGGGT|GGGGGGGGGGGGTGGGGGGGGGGGGGGGGGGGGGGGGGGGGGGGGGGGGGGGGGGGGGGGGGGGGGGGGGTTGGGTGGGG
GGGGGGGGG|GGGGGGGGGGGGGTGGGGGGGSGGGGGSGGGGGGGGGGGGGGGGGGGSGGGGGGGGGGGGGGGGSGGGGGGGTGGGTGGG
GGGGGGGGG|GGGGGGGGGGGGGGTGGGGGGGGGGGGGGGGGGGGGGGGGGGGGGGGGGGGGGGGGGGGGGGGGGGGGGGTGGTGGGTGG
GGGGGGGGG-----<>------TGGGGGGGGGGGGGGGGGGGGGGGGGGGGGGGGGGGGGGGGGGGGGGGGGGGGGGGGGGTGGTGGGGG
GGGGGGGGGGGGGGGGGGGGGGGTGGGTGGTGGTGGGTGGTGGTGTGGTGGTGTGTGGTGTGTGTGGTGTGGTGTGTGGTGTTTGTGGGG
GGGGGGGGGGGGGGGGGGGGGGTGTGGGTGGTGTGTGGTGTGTGGTTGGGGTGTGGTGGGTGGGGTGGTGGGGTGTGTGGGGTGGGGGGG
GGGGGGGGGGGGGGGGGGGGGGGGGTGTGGTGTGTGGTGTGTGTGTGTGTGGTGTGGTGTGGTGGGGTGGGTGGTGTGGTGTGGGGTGGG
GGGGGGGGGGGGGGGGGGGGGGTGGGTGGTGGTGTGGTGTGGTTGTGGGGTGGGGTGGGGGGGTGGGGGGGGTGGGGGGGTGGTGGGGGG
GGGGGGGGGGGGGGGGGGGGGGGGGTGTGGTGTGTGGTGTGTGTGTGTGTGGTGTGGTGTGGTGGGGTGGGTGGTGTGGTGTGGGTGGGG
GGGGGGGGGGGGGGGGGGGGGGTGGGTGGTGGTGTGGTGTGGTTGTGGGGTGGGGTGGGGGGGTGGGGGGGGTGGGGGGGTGGTGGTGGG
GGGGGGGGGGGGGGGGGGGGGGGGGGGGGGGGGGGGGGGGGGGGGGGGGGGGGGGGGGGGGGGGGGGGGGGGGGGGGGGGGGGGGGGGGG
GGGGGGGGGGGGGGGGGGGGGGGGGGGGGGGGGGGGGGGGGGGGGGGGGGGGGGGGGGGGGGGGGGGGGGGGGGGGGGGGGGGGGGGGGG