HBBBBBBBBBBBBBBBBBBBBBBBBBD
MGGGGGGGGGGGGGGGGGGGGGGGGGV
MGGGGPGGGGGGGGGGGGGGGGGGGGV
MGG0GGGGGGGGGGGGGGGGGGGGGGV
MGGGGGGGGGGGGGGGGGGGGGGGGGV
MGGGGGGGGGGGGGGGGGGGGGGGGGV
MGGGGGGGGGGGGGGGGGGGGGGGGGV
MGGGGGGGGGGGGGGGGGGGGGGGGGV
MGGGGGGGGGGGGGGGGGGGGGGGGGV
MGGGGGGGGGGGGGGGGGGGGGGGGGV
MGGGGGGGGGGGGGGGGGGGGGGGGGV
MGGGGGGGGGGGGGGGGGGGGGGGGGV
HBBBBBBBBBBBBBBBBBBBBBBBBBD