BBBBBBBBBBB
BGGGGGGGGGB
BGGGGGGGGGB
BGGGGGGGpGD
BGGGGGGGGGB
BGGGGGGGGGB
BBBBBBBBBBB