------------------------
|WWWWWWWWWWWWWWWWWWWWWW|
|WWWWWWWWWWWWWWWWWWWWWW|
|WWWWWWWWWWWWWWWWWWWWWW|
|WWWWCCCCCCPCCCCCCCWWWW|
|WWWWCCCCCCCCCCCCCCWWWW|
|WWWWCCCCCCCCCCCCCCWWWW|
|WWWWCCCCCCbCCCCCCCWWWW|
|WWWWCCCCCCCCCCCCCCWWWW|
|WWWWCCCCCCCCCCCCCCWWWW|
--WWWWCCCCCCCCCCCCWWWW--
*|-WWWWCCCCCCCCCCWWWW-|*
**|-WWWWCCCCCCCCWWWW-|**
***|-WWWWCCCCCCWWWW-|***
****|-WWWWCCCCWWWW-|****
****|-WWWWCCCCWWWW-|****
****|-WWWWCpCCWWWW-|****
****|-WWWWCCCCWWWW-|****
*****|------------|*****