|--------------------------------------------------------------------------------|
|CCCCCCCCCCCCCCCCCCCCCCCCCCCCCCCCCC|CCCCCCCCC|CCCCCCCCCCCCCCCCCCCCCCCCC|CCCCpCCCC|
|CCCCCCCCCCCSCCCCCCCCCCCCCCCCCCCCCC|CCCCCCCCC|CCCCCCCCCCSCCCCCCSCCCCCCC|CCCCCCCCC|
|CCCCCCCCCCCCCCC|CCCCCCCCCCCCCCCCCCCCCCCCCCCC|CCCCCCCCCCCCCCCCCCCCCCCCC|CCCCCCCCC|
|CCCCCCCCCCCCCCC|CCCCCCCSCCCCCCCSCCCCCCCCCCCC|CCCCCCCCCCCCCCCCCCCC|CCCC|CCCCCCCCC|
|------------CCC|CCCCCCCCCCCCCCCCCCCCCCCCCCCC|CCCCCCCCCCCCbCCCCCCC|CCCC|CCCCCCCCC|
|CCCCCCCCCCCCCCC|CCCCCCCCCCCCCCCCCC|CCCCCCCCC|CCCCCCCCCCCCCCCCSCCC|CCCC|CCCCCCCCC|
|CCCCCCCCSCCCCCC|CCCCCCCCCCCCCCCCCC|CCCCCCCCC|CCCCCCCCCCCCCCCCCCCC|CCCC|CCCCCCCCC|
|CCCCCCCCCCCCCCC|CCCCCCCCCCCCCCCCCC|CCCCCCCCC|CCCCCCCCCCCCCCCCCCCC|CCCC|CCCCCCCCC|
|CSCCCCCCCCCCCCC|CCCCCCCCCCCCCCSCCC|CCCCCCCCCCCCCCCSCCCCCCSCCCCCCC|CCCC|CCCCCCCCC|
|CCCC-----------|-----------CCCCCCC|CCCCCSCCCCCCCCCCCCCCCCCCCCCCCC|CCCC|CCCCCCCCC|
|CCCC|CCCCCCCCCC|CCCCCCCCCCCCCCCCCC|CCCCCSCCCCCCCCCCCCCCCCCCCCCCCC|CCCC|CCCCCCCCC|
|CCCC|CCCCCCCCCC|CCCCCCCCCCCCCCCCCC|CCCCCCCCCCCCCCCCCCCCCCCCCCCCCC|CCCC|CCCCSCCCC|
|CCCC|CCCCbCCCCC|CCCCCCCCCCCCCCCCCC|CCCCCCCCCCCCCCCCCCCCCCCCCCCCCC|CCCC|CCCCCCCCC|
|CCCC|CCCCCCCCCC|------------------|CCCCCCCCC|---------------------CCCC|CCCCCCCCC|
|CCCCCCCCCCCCCCC|CCCCCCCCCCCCCCCCCC|CCCCCCCCC|CCCCCCCCCCCCCCCCCCCCCCCCC|---CCCCCC|
|CCCCCCCCCCCCCCC|CCCCCCCCCCCCCCCCCC|CCCCCCCCC|CCCCCCCCCCCCCCCCCCCCCCCCCCCCCCCCCCC|
|CCCC-----------|CCCCCCCCCCCCCCCCCC|CCCCCCCCC|CCCCCCCCCSCCCCSCCCCCCCCCCCCCCCSCCCC|
|CCCCCCCCCCCCCCCCCCCCCSCCCCCCCCCCCC|CCCCCCCCC|CCCCCCCCCCCCCCCCCCCCCCCCCCCCCCCCCCC|
|CCCCCCCSCCCCCCCCCCCCCCCCCCCCCCCCCC|CCCCCCCCC|CCCCCCCCCCCCCCCCCCCCCCCCCCCCCCCCCCC|
|CCCSCCCCCCCCCCCCCCCCCCCCCCCCCCCCCC----------------------------------------------|
|CCCCCCCCSCCCCCCCCCCCCCCCCCCCSCCCCC|CCCCCCCCCCCCCCCCCCCCCCCCCCCCCCCCCCCCCCCCCCCCC|
|CCCCCCCCCCCCCCCCCCCCCCCCCCCCCCCCCC|CCSCCCCCCCCCCCCCCCSCCCCCCCCCCCCCCCCCCCCCCCCCC|
|----------------------CCCCCCCCCCCC|CCCCCCCCCCCCCCCCCCCCCCCCCCCCCCCCCCCCCCCCCSCCC|
|CCCCCCCCCCCCCCCCCCCCCCCCCCCCCCCCCC|CCCC----------------------------------|CCCCCC|
|CCCCCCCCCCCCCCCCCCCCCCCCCCCCCCCCCC|CCCCCCCCCCCCCCCCCCCCCCCCCCCCCCCCCCCCCC|CCCCCC|
|CCCCCCCCCCCCSCCCSCCCCCCCCCCCSCCCCC|CCSCCCCCCCCCCCCCSCCCCCCCCCCCCCCCCbCCCC|CCCCCC|
|CCCCCCCCCCCCCCCCCCCCC|CCCCCCCCCCCC|CCCCCCCCCCCCCCCCCCCCCCCCCCCCCCCCCCCCCC|CCCCCC|
|CCSCCCCCCCCCCCCCCCCCC|CCCCCCCCCCCC|---------------------------------------CCSCCC|
|CCCCCCCCCCCCCCCCCCCCC|CCCCCCCCCCCCCCCCCCCCCCCCCCCCCCCCCCCCCCCCCCCCCCCCCCCCCCCCCC|
|CCCCC----------------|CCCCCCCCCCCCCCCCCCCCCCCCCCCCCCCCCCCCCCCCCCCCCCCCCCCCCCCCCC|
|CCCCCCCCCCCCCCCCCCCCC|CCCCCCCCSCCCCCCCCCCSCCCCCCCCCCCCCSCCCCCCCCCCCCSCCCCCCCCCCC|
|CCCCCCCCCCCCCCCCCCCCC|CCCCCCCCCCCCCCCCCCCCCCCCCCCCCCCCCCCCCCCCCCCCCCCCCCCCCCCCCC|
|CCCCSCCCCCCCCCCCCCCCC|----------------------------------------------------CCCCCC|
|CCCCSCCCCCCCCbCCCCCCC|CCCCCCCCCCCCCCCCCCCCCCCCCCCCCCCCCCCCCCCCCCCCCCCCCCC|CCCCCC|
|CCCCCCCCCCCCCCCCCCCCC|CCCCCCCCCCCCCCCCSCCCCCCCCCSCCCCCCCCCCCCCCCCCCCCCCCC|CCSCCC|
|CCCCCCCCCCCCCCCCCCCCC|CCCCSCCCCCCCCCCCCCCCCCCCCCCCCCCCCCCCCCCCCCCCSCCCCCC|CCCCCC|
|---------------------|CCCCCCCCCCCCCCCCCCCCCC-----------------|CCCCCCCCCCC|CCCCCC|
|CCCCCCCCCCCCCCCCCCCCCCCCCCCCCCCC|CCCCCCCCCCCCCCCCCCCCCCCCCCCC|CCCCCCCCCCC|CCCCCC|
|CCCCCCCCCCCCCbSCCCCCCCCCCCCSCCCC|CCCCCSCCCCCCCCCCCCCCSCCCCCCC|CCCCCSSCCCCCCCCCCC|
|CC^CCCCCCCCCCbSCCCCCCCCCCCCCCCCC|CCCCCCCCCCCCCCCCCCCCCCCCCCCC|CCCCCCCCCCCCCCSCCC|
|CCCCCCCCCCCCCCCCCCCCCCCCCCCCCCCC|CCCCCCCCCCCCCCCCCCCCCCCCCCCC|CCCCCCCCCCCCCCCCCC|
|--------------------------------------------------------------------------------|