GGGGGGGGGGGGGGGGGGGGGGGGGGGGGGGGGGGGGGGGGGGGGGGGGGGGGGGGGGGGGGGGGGGGGGGGGGGGGGGGGGGGGGGGGGGGGGGGGGGGGGGQQQQQQQQQQQQQQQQQQQQQQQ
GGGGGGGGGGGGGGGGGGGGGGGGGGGGGGGGGGGGGGGGGGGGGGGGGGGGGGGGGGGGGGGGGGGGGGGGGGGGGGGGGGGGGGGGGGGGGGGGGGGGGGGDQDDDDDDDDDDDDDDDDDDDDD
GGGGGGGGGGGGGGGGGGGGGGGGGGGGGGGGGGGGGGGGGGGGGGGGGGGGGGGGGGGGGGGGGGGGGGGGGGGGGGGGGGGGGGGGGGGGGGGGGGGGGGGQQDDDDDDDDDDDDDDDDDDDDD
GGGGGGGGGGGGGGGGGGGGGGGGGGGGGGGGGGGGGGGGGGGGGGGGGGGGGGGGGGGGGGGGGGGGGGGGGGGGGGGGGGGGGGGGGGGGGGGGGGGGGGGQDDDDDDDDDDDDDDDDDDDDDD
GGGGGGGGGGGGGGGGGGGGGGGGGGGGGGGGGGGGGGGGGGGGGGGGGGGGGGGGGGGGGGGGGGGGGGGGGGGGGGGGGGGGGGGGGGGGGGGGGGGGGGGQDDDDDDDDDDDDDDDDDDDDDD
GGGGGGGGGGGGGGGGGGGGGGGGGGGGGGGGGGGGGGGGGGGGGGGGGGGGGGGGGGGGGGGGGGGGGGGGGGGGGGGGGGGGGG@GG@GGGGGGGGGGGGGQDDDDDDDD$DDDDDDDDDDDDD
@@@@@@@@@@@@@@@@@@@@@@@@@@@@@@QQQQQQQQQQQQQQQQQQQQQQQQQQQQQQQQQQQQQQQQQQQQQQQQQQQQQQQQQ{}QQQQQQQQQQQQQQQQQQQQQQQQQQQQDDDDDDDDD
@@@@@@@@@@@@@@@@@@@@@@@@@@@@QQDDDDDDDDDDDDDDDDDDDDDDDDDDDDDDDDDDDDQDDDDD$DDDDD$DDDDDDDDDDDDDDD$DDDDDDDDDDD$DDDDDDDDDQDDDDDDDDD
@@@@@@@@@@@@@@@@@@@@@@@@@@@QQDDDDDDDDDDDDDDDDDDDDDDDDDDDDDDDDDDDDDQDDDDDDDDDDDDD$DDDDDDDDDDDDDDDDDDDDDDDDDDDDDDDDDDDQDDDDDDDDD
@@@@@@@@@@@@@@@@@@@@@@@@@@QQDDDDDDDDDDDDDDDDDDDDDDDDDDDDDDDDDDDDDDQDD$DDDDDD$DDDDDDDDDDDDDDDDD$DDDDDDDDDDDDDDDDDDDDDQDDDDDDDDD
@@@@@@@@@@@@@@@@@@@@@@@@@@QDDDDDDDDDDDDDDDDDDDDDDDDDDDDDDDDDDDDDDDQDD$DDDDDD$DDDDDDDDDDDDDDDDD$DDDDDDDDDDDDDDDDDDDDDQDDDDDDDDD
@@@@@@@@@@@@@@@@@@@@@@@@@@QDDDDDDDDDDDDDDDDDDDDDDDDDDDDDDDDDDDDDDDQDD$DDDDDD$DDDDDDDDDDDDDDDDD$DDDDDDDDDDDDDDDDDDDDDQDDDDDDDDD
@@@@@@@@@@@@@@@@@@@@@@@@@@QDDDDDDDDDDDDDDDDDDDDDDDDDDDDDDDDDDDDDDDQDD$DDDDDD$DDDDDDDDDDDDDDDDDDDDDDDDDDDDDSDDDDDDDDDQDDDDDDDDD
@@@@@@@@@@@@@@@@@@@@@@@@@@QDDDDDDDDDDDDDDDDDDDDDDDDDDDDDDDDDDDDDDDQDD$DDDDDD$DDDDDDDDDDDDDDDDDDDDDDDDDDDDDDDDDDDDDDDQDDDDDDDDD
@@@@@@@@@@@@@@@@@@@@@@@@@@QDDDDDDDDDDDDDDDDDDDDDDDDDDDDDDDDDDDDDDDQDD$DDDDDD$DDDDDDDDDDDDDDDDDDDDDDDDSDDDDDDDDDDDDDDQDDDDDDDDD
@@@@@@@@@@@@@@@@@@@@@@@@@@QDDDDDDDDDDDDDDDDDDDDDDDDDDDDDDDDDDDDDDDQDD$DDDDDD$DDDDDDDDDDDDDDDDDDDDDDDDD$DDDDDDDDDDDDDQDDDDDDDDD
QQQQQQQQQQQQQQQQQQQQQQQQQQQQQQQQQQQQQQQQQQQQQQQQQQQQQQQQQQQQQQQQQQQDD$DDDDDD$DDDDDDDDDDDDDDDDDDDDDDDDD$$DDDDDDDDDDDDQDDDDDDDDD
DDDDDDDDQDDDDDDDDDDDDDDDDDDDDDDDDDDDDDQDDDDDDDDDDDDDDDDDDDDDDDDDQDQQQQQQQQQQQQQQQQQQQQQQQQQQQQQQQQQQQQQ$$DDDDSDDDDDDQDDDDDDDDD
DDDDDDDDQDDDDDDDDDDDDDDDDDDDDDDDDDDDDQDDDDDDDDDDDDDDDDDDDDDDDDDQDDDDDDQDDDDDDDDDDDDDDDDDDDDDDDDDDDDDDDQDDDDDDDDDDDDDQDDDDDDDDD
DDDDDDDDQDDQQQQDDQDQDDQQQQDDDDDDDDDDQDDDDQQQDDDDDDDDDDDDDDDDDDQDDDDDDDDQDDDDDDDDDDDDDDDDDDDDDDDDDDDDDDQDDDDDDDDDDDDDQDDDDDDDDD
DDDDDDDDQDDQ$$QDQDQDQDQ$$QDDDDDDDDDQDDDDQDDDQDDDDDDDDDSDDDDDDQDDDDDDDDDDQDDDDDDDDDDDDDDDDDDDDDDDDDDDDDQDDDDDDDDDDDDDQDDDDDDDDD
DDDDDDDDQDDQQQQDQDQDQDQQQQDDDDDDDDQDDDDQDDDDDQDDDDDDDDDDDDDDQDDDDDDDDDDDDQDDDDDDSDDDDDDDDDDDDDDDDDDDDDQDDD$DDDDDDDDDQDDDDDDDDD
DDDDDDDDQDDQ$$QDQDDDQDQDDDDDDDDDDQDDDDQDD$$DDDQDDDDDDDDDDDDQDDDDDDDDDDDDDDQDDDDDDDDDDDDDDDDDDDDDDDDDDDQDDDDDDDDDDDDDQDDDDDDDDD
DDDDDDDDQDDQQQQDQDDDQDQDDDDDDDDDQDDDDDQDD$$DDDQDDDDDDDDDDDQDDDDDDDDDDDDDDDDQDDDDDDDDDDDSDDDDDDDDDDDDDDQDDDDDDSDDDDDDQDDDDDDDDD
DDDDDDDDQDDDDDDDDDDDDDDDDDDDDDDDDDDDDDDQDDDDDQDDDDDDDDDDDDDDDDDDDDDDDDDDDDDDQDDDDDDDDDDDDDDDDDDDDDDDDDQDDDDDDDDDDDDDQDDDDDDDDD
DDDDDDDDQDDDDDDDDDDDDDDDDQDDDDDDDDDDDDDDQDDDQDDDDDDDDDDDDDDDDDDDDDDDDDDDDDDDDQDDDDDDDDDd$DDD$DDDDDDDDDQDDDDDDDDDDDDDQDDDDDDDDD
DDDDDDDDQDDDDDDDDDDDDDDDQDDDDDDDDDDDDDDDDQQQDDDDDDDDDDDDDDDDDDDDDDDDDDDDDDDDDDQDDDDDDDDDd$D$DDDDDDDDDDQDDDDDDDDDDDDDQDDDDDDDDD
DDDDDDDDQDDDDDDDDDDDDDDQDDDDDDDSDDDDDDDDDQQQDDDDDDDDDDDDDDDDDDDDDDDDDDDDDDDDDDDQDDDDDDDDDD$DDDDDDDDDDDQDDDD$DDDDDDDDQDDDDDDDDD
DDDDDDDDQDDDDDDDDDDDDDQDDDDDDDDDDDDDDDDDQDDDQDDDDDDDDDSDDD$DDDDDDDDDDDSDDDDDDDDQDDDDDDDDDDQDDDDDDDDDDDQDDDDDDDDDDDDDQDDDDDDDDD
DDDDDDDDQQQQQQQQQQQQQQDDDDDDDDDDDDDDDDDQDDDDDQDDDDDDDDDDD$DDDDDDDDDDDDDDDDDDDDDQDDDDDDDDDDQDDDDDDDDDDDQDDDDDDSDDDDDDQDDDDDDDDD
DDDDDDDDQDDDDDDDDDDDDD$DDDD$DDDDDDDDDDQDDDDDDDQDDDDDDDDD$DDDDDDDDDDDDDDDDDDDDDDQDDDDDDDDDDQDDDDDDDDDDDQDDDDDDDDDDDDDQDDDDDDDDD
DDDDDDDDQDDDDDDDDDDDDDD$DD$DDDDDDDDDDQDDDDDDDDDQDDDDDDDQDDDDDDDDDDDDDDDDDDDDDDDQDDDDDDDDDDQDDDDDDSDDDDQDDDDDDDDDDDDDQDDDDDDDDD
DDDDDDDDQDDDDDDDDDDDDDDD$$DDDDDDDDDDDDDDDDDDDDDDDDDDDDQDDDDDDDDDDDDDDDDDDDDDDDDQDDDDSDDDDDQDDDDDDDDDDDQDDDDDDDDDDDDDQDDDDDDDDD
DDDDDDDDQDDDDDDDDDDDDDD$D$DDDDDDDDDDDDDDDDDDDDDDDDDDDQDDDDDDDDDDDDDDDDDDDDDDDDDQDDDDDDDDDDQDDDDDDDDDDDQDDDDD$DDDDDDDQDDDDDDDDD
DDDDDDDDQDDDDDDDDDDDDD$DDD$DDDDDDDDDDDDDDDDDDDDDDDDDQDDDDDDDDDDDDDDDDDDDDDDDDDDQDDDDDDDDDDQDDDDDDDDDDDQDDDDDDDDDDDDDQDDDDDDDDD
DDDDDDDDQDDDDDDDDDDDD$DDDDD$DDDDDDSDDDDDDDDDDDDDDDDQDDDDDDDDDDDDDDDDDDDDDDDDDDDQDDDDDDDDDDQDDDDDDDDDDDQDDDDDDDDDDDDDQDDDDDDDDD
DDDDDDDDQDDDDDDDDDDDDDDDDDDDDDDDDDDDDDDDDDDDDDDDDDQ$DDDDDDDSDDDDDDDDDDDSDDDDDDDQDDDDDDDDDDQDDDDDDDDDDDQDDDDDD$DDDDDDQDDDDDDDDD
DDDDDDDDQDDDDDDDDDDDDDDDDDDDDDDDDDDDDDDDDDDDDDQQQQDD$DDDDDDDDDDDDDDDDDDDDDDDDDDQDDDDDDDDDDQDDDDDDDDDDDQDDDDDDDDDDDDDQDDDDDDDDD
DDDDDDDDQDDDDDDDDDDDDDDDDDDDDDDDDDDDDDDDDDDDDQDDDDDDD$DDDDDDDDDDDDDDDDDDDDDDDDDQDDDDDDDDDDQDDDDDSDDDDDQDDDDDDDDDDDDDQDDDDDDDDD
DDDDDDDDQDDDDDDDDDDSDDDDDDDDSDDDDDDDDDDDDDDDDQDDDDDDDDDDDDDDDDDDDDDDDDDDDDDDQQQQDDDDDDDDDDQDDDDDDDDDDDQDDDDDDDDDDDDDQDDDDDDDDD
DDDDDDDDQDDDDDDDDDDDDDDDDDDDDDDDDDDDDDDDDDDDDQDDDDDSDDDDDDDDDDDDDDDDDDDDDDDQDDDDDDDDDDDDDDQDDDDDDDDDDDQDDDDDDDDDDDDDQDDDDDDDDD
DDDDDDDDQDDDDDDDDDDDDDDDDDDDDDDDDDDDDDDDDDDDDQDDDDDDDDDDDDDDDDDDDDDDDDDDDDQDDDDDDDDDDDDDDDQDDDDDDDDDDDQDDDDDDDDDDDDDQDDDDDDDDD
DDDDDDDDQDDDDDDDDDDDDDDDDDDDDDDDDDDDDDDDDDDDDQDDDDDDDDDDDDDDDDDDDDDDDDDDDQDDDDDD$DSDDDDDDQDDDDDDDDDDDDQDDDDDDSDDDDDDQDDDDDDDDD
DDDDDDDDQDDDDDDDDDDDDDDDDDDDDDDDDDDDDDDDDDDDDQDDDDDDDDDDDDDDDDSDDDDDDDDDQDDDDDD$$$DDDDDDQDDDDDDDDDDDDDQDDDDDDDDDDDDDQDDDDDDDDD
DDDDDDDDQDDDDDDDDDDDDDDDDDDDDDDDDDDDDDDDDDDDDQDDDDDDDDDDDDDDDDDDDDDDDDDQDDDDDDDD$DDDDDDQDDDDDDDDDDDDDDQDDDDDDDDDDDDDQDDDDDDDDD
DDDDDDDDQDDDDDDDDDDDDDDDDDDDDDDDDDDDDDDDDDDDDQDDDDDDDDDDDDDDDDDDDDDDDDQDDDDDDDDDDDDDDDQDDDDDDDDDDDDDDDQDDDDDDDDDDDDDQDDDDDDDDD
DDDDDDDDQDDDDDDDDDDDDDDDDDDDDDDDDDDDDDDDDDDDDQDDDDDDDDDDDDDDDDDDDQQQQQDDDDDDDDDDDDDDDQDDDDDDDDDDDDDDDDQDDDDDDDDDDDDDQDDDDDDDDD
DDDDDDDDQDDDDDDDDDDDDDDDDDDDDDDDDDDDDDDDDDDDDQDDDDDDDDDDDDDDDDDDQDDDDDDDDDDDDDDDDDDDQDDDDDDSDDDDDDSDDDQDDDDDDD$DDDDDQDDDDDDDDD
DDDDDDDDQDDDDDDDDDDDDDDDDDDDDDDDDDDDDDDDDDDDDQDDDDDDSDDDDDDDDDDQDDDDDDDDDSDDDQQQQQQQDDDDDDDDDDDDDDDDDDQDDDDDDDDDDDDDQDDDDDDDDD
DDDDDDDDQDDDDDDDDDDDDDDDDDDDDDDDDDDDDDDDDDDDDQDDDDDDDDDDDDDDD$QDDDDDDDDDDDDDQDDDDDDD$DDDDDDDDDDDDDDDDDQDDDDDDDDDDDDDQDDDDDDDDD
DDDDDDDDQDDDDDDDDDDDDDDDDDDDDDDDDDDDDDDDDDDDDQDDDDDDDDDDDDDDD$$DDDDDDDDDDDDQDDDDDDDDD$DDDDDSDDDDDDDDDD$$DDDDDDDDDDDDQDDDDDDDDD
DDDDDDDDQDDDDDDDDDDDDDbDDDDDDDDDDDDDDDDDDDDDDQDDDDDDDDDDDDDDDDDDDDDDDDDDDDQDDDDDDDDDDD$DDDDDDDDDDDDDDD$DDDDDDDDDDDDDQDDDDDDDDD
DDDDDDDDQDDDDDDDDDDDDDDDDDDDDDDDDDDDDDDDDDDDQDDDDDDDDDDDDSDDDDDDDDDDDDDDDQDDDDDDDDDDDDDDDDDDDDDDDDDDDDDDDDDDSDDDDDDDQDDDDDDDDD
DDDDDDDDQDDDDDDDDDDDDDDDDDDDDDDDDDDDDDDDDDDQDDDDDDDDDDDDDDDDDDDDDDDDDDDDQDDDDDDDDDDDDDDDDDDDSDDDDDDDDDDDDDDDDDDDDDDDQDDDDDDDDD
DDDDDDDDQDDDDDDDDDDDDDDDDDDDDDDDDDDDDDDDDDQDDDDDDDDDDDDDDDDDDDDDDDDDDDDQDDDDDDDDDDDDDDDDDDDDDDDDDDDDDDDDDDDDDDDDDDDDQDDDDDDDDD
DDDDDDDDQDDDDDDDDDDDDDDDDDDDDDDDDDDDDDDDDQDDDDDDDDDDDDDDDDDDDDDDDDDDDDQDDDDDDDDDDDDDDDDDDDDDDDDDDDDDDDDDDDDDDDDDDDDDQDDDDDDDDD
DDDDDDDDQQQQQQQQQQQQQQQQQQQQQQQQQQQQQQQQQQQQQQQQQQQQQQQQQQQQQQQQQQQQQQQQQQQQQQQQQQQQQQQQQQQQQQQQQQQQQQQQQQQQQQQQQQQQQDDDDDDDDD
QQQQQQQQQQQQQQQQQQQQQQQQQQQQQQQQQQQQQQQQQQQQQQQQQQQQQQQQQQQQQQQQQQQQQQQQQQQQQQQQQQQQQQQQQQQQQQQQQQQQQQQQQQQQQQQQQQQQQQQQQQQQQQ
QQQQQQQQQQQQQQQQQQQQQQQQQQQQQQQQQQQQQQQQQQQQQQQQQQQQQQQQQQQQQQQQQQQQQQQQQQQQQQQQQQQQQQQQQQQQQQQQQQQQQQQQQQQQQQQQQQQQQQQQQQQQQQ
QQQQQQQQQQQQQQQQQQQQQQQQQQQQQQQQQQQQQQQQQQQQQQQQQQQQQQQQQQQQQQQQQQQQQQQQQQQQQQQQQQQQQQQQQQQQQQQQQQQQQQQQQQQQQQQQQQQQQQQQQQQQQQ
QQQQQQQQQQQQQQQQQQQQQQQQQQQQQQQQQQQQQQQQQQQQQQQQQQQQQQQQQQQQQQQQQQQQQQQQQQQQQQQQQQQQQQQQQQQQQQQQQQQQQQQQQQQQQQQQQQQQQQQQQQQQQQ
QQQQQQQQQQQQQQQQQQQQQQQQQQQQQQQQQQQQQQQQQQQQQQQQQQQQQQQQQQQQQQQQQQQQQQQQQQQQQQQQQQQQQQQQQQQQQQQQQQQQQQQQQQQQQQQQQQQQQQQQQQQQQQ
QQQQQQQQQQQQQQQQQQQQQQQQQQQQQQQQQQQQQQQQQQQQQQQQQQQQQQQQQQQQQQQQQQQQQQQQQQQQQQQQQQQQQQQQQQQQQQQQQQQQQQQQQQQQQQQQQQQQQQQQQQQQQQ