**********************************************************************************
**********************************************************************************
**********************************************************************************
*******BBBBBBBBBBBBBBBBBBBBBBBBBBBBBBBBBBBBBBBB***********************************
*******BGGGGGGGGGGGGGGGGGGGGGGGGGGGGGGGGGGBBBBBBBBBBBBBBBBB***********************
*******BGGSGGGGGGGGGGGGGGGGGGGGGGGGGGGGGGGGGGGGGGGGGGGGGGGGBBBBBBBBBB*************
*******BGGGGGGBBBBBBBBBGGGGGGGGGGGGGGGGGGGGGGGGGGGGGGGGGGGGGGGGGGGGGB*************
*******BGGGGGGBGGGGGGGBGGGGGGGGGGGGGGGGBBBBBBBBBBBBBGGGGGGGGGGGSGGGGB*************
*******BGGGGGGBGGGSGGGBBBBBBBBBBGGGGGGGGBGGGGGGGGGGGBGGGGGGGGGGGGGGGB*************
*******BGGGGGGBGGGGGGGGGGGGGGGGBGGGGGGGGGBGGGGSGGGGGGBBBBBBBGGGGGGGGGBBBBBBBBBB***
*******BGGGGGGBGGGGGGGGGGGGGGGGBGGGGGGGGGGBGGGGGGGGGGGGGGGGBGGGGGGGGBGGGGGGGGGB***
*******BGGGGGGBBBBBBBBGGGGGGGGGGBGGGGGGGGGGBGGGGGGGGGSGGGGGBGGGGGGGGBGGGGGGGGGB***
*******BGGGGGGGGGGGGGGBGGGGGGGGGGBGGGGGGGGGBGGGGBBBBBBBBBBBBGGGGGGGBGGGGGGGGGGB***
********BGGGGGGGGGGGGGBGGGGGGGGGGGGGGGGGGGGBGGGGGGGGGGGGGGGGGGGGGGGSGGGGGbGGGGB***
*********BBBBBBBBBBBBBBBBBGGGGGGGGGGGGGGGGGBGGGGGGGGGGGGGGGGGGGGGGGGGGGGGGGGPGB***
**************************BBBBBBBBBBBBBBBBBBBBBBBBBBBBBBBBBBBBBBBBBBBBBBBBBBBB****
