*****BBBBBBBBBBBBBBBBBBWWWWWWWWWWWWWWWBBBBBBBBBB****************
****BGGGGGGGGGGGGGGGGGGWWWWWWWWWWWWWWWGGGGGGGGGGBBBB************
***BBGGGGGGGGGGGGGGGGGGWWWWWWWWWWWWWWWGGGGGGGpGGGGGGBB**********
**BGGGGGGGsGGGGGGGGGGGGWWWWWWWWWWWWWWWGGGGGGGGGGGGGGGB**********
*BGGGGGGGGGGGGGGGGGGGGGWWWWWWWGGWWWWWWGGGGGGGGGGGGGGGGB*********
BGGGGGGGGGGGGGGGGGGGGGWWWWWWWGGGGWWWWWWGGGGGGGGGGGGGGGGB********
BGGGGGGGGGGGGGGGGGGGGWWWWWWWGGGGGGWWWWWWGGGGGGSGGGGGGGGGBBB*****
*BGGGGGGGGGGGGGGGGGGGWWWWWWWGGGGGGGWWWWWWGGGGGGGGGGGGGGGGGGB****
*BGGGGGGGGGGGGGGsGGGG=======GGGGGGGGWWWWWWGGGGGGGGGGGGGGGGGGB***
*BGGGGGGGGGGGGGGGGGGG=======GGGGGGGGGWWWWWWGGGGGGGGGSGGGGGGGGBB*
*BGGGGGGGGGGGGGGGGGGGWWWWWWWGGGGGGGGGGWWWWWWGGGGGGGGGGGGGGGGGGGB
BGGGGGGGGsGGGGGGGGGGWWWWWWWGGGGGGGGGGGGWWWWWWGGGGGGGGGGGGGGGGGGB
BGGGGGGGGGGGGGGGGGGWWWWWWWGGGGGGGGGGGGGWWWWWWGGGGGGGGGGGGGGGGGGB
BGGGGGGGGGGGGGGGGGWWWWWWWGGGGGGGGGGGGGGWWWWWWGGGGGGGGGGGGGGGGGGB
BGGGsGGGGGGGGGGGGWWWWWWWGGGGGGGGGGGGGGGWWWWWWGGGGGGGSGGGGGGGGGGB
BGGGGGGGGGGGGGGGWWWWWWWGGGGGGGbGGGGGGGGGWWWWWWGGGGGGGGGGGGGGGGGB
BGGGGGGGGGGGGGGWWWWWWWGGGGGGGGGGGGGGGGGGGGWWWWWWGGGGGGGGGGGGGGGB
BGGGGGGGGGGGGGWWWWWWWGGGGGGGGGGGGGGGGGGGGGGGWWWWWWGGGGGGGGGGGGGB
BGGGGGGGGGGGWWWWWGWWWWGGGGGGGGGGGGGGGGGGGGGGGGGWWWWWWGGGGGGGGGGB
BGGGGGGGGGGWWWWWGGWWWWGGGGGGGGGGGGGGGGGGGGGGGGGGWWWWWW++WWWWWWWW
BGGGbGGGGGWWWWWGGGGWWWWGGGGGGGGGGGGGGGGGGGGGGGGGGGGGWW++WWWWWWWW
BGGGGGGGGGWWWWWGGGGGWWWWGGGGGGSGGGGGGGGGGGGGGGGGGGGGGGGGGGGGGGGB
BGGGGGGGGGWWWWWGGGGGGWWWWGGGGGGGGGGGGGGGSGGGGGGGGGGGGGGGGGGGGGGB
BGGGGGGGG=====GGGGGGGGWWWWGGGGGGGGGGGGGGGGGGGGGGGGGSGGGGGGGGGGGB
BGGGGGGG=====GGGGGGGGGGWWWWGGGGGGGGGGGGGGGGGGGGGGGGGGGGGGGGGGGB*
BGGGGWWWWWGGGGGGGGGGGGGGWWWWGGGGGGGGGGGGGGGGGGGGGGGGGGGGGGGBBB**
WWWWWWWWWGGGGGGGGGGGGGGGGWWWWGGGGGGGGGGGGGGGGGGGGGGGGGGGGGBGGB**
WWWWWWWWGGGGGGGSGGGGGSGGGGWWWWGGGGGGGGGGGGGGGGGGGGGGGGGGGBGGGB**
BGGGGGGGGGGGGGGGGGGGGGGGGGGWWWWGGGGGGGGGGSGGGGGGGGGGGGGGBGGGGB**
*BGGGGGGGGGGGGGGGGGGGGGGGGGGWWWWGGGGGGGGGGGGGGGGGGGGGGGBGGGGGB**
**BGGGGGGGGGGGGGGGGGGGGGGGGGGWWWWGGGGGGGGGGGGGGGGGGGGGBGGGGGGB**
***BBBBBGGGGGGGGGGGGGGGGGGGGWWWGWWWGGGGGGGGGGGGGGGGGGBGGGGPGGB**
********BGGGGGGGGGGGGGGGGGGWWWBBWWWBBBBBBBBBBBBBBBBBBGGGGGGGGB**
********BGGGGGGGGGGGGGGGGGWWWGGGWWWGGGGGGGGGGGGGGGGGGGGbGGGGGGB*
*********BGGGGGGGGGGGGGGGGWWWGGGGWWWGGGGGGGGGGGGGGGGGGGGGbGGGGGB
**********BGGGGGGGSGGGGGGWWWGGGGGGWWWGGGGGGGGGSGGGGGGGGGGGGGGGGB
***********BGGGGGGGGGGGGGWWWGGGGGGGWWWGGGGGGGGGGGGGGGGGGGGGGGGGB
***********BGGGGGGGGGGGGWWWGGGGGGGGGWWWWWWWWWWWWWW++WWWWWWWWWWWW
***********BGGGGGGGGGGGGWWWGGGGGGGGGGWWWWWWWWWWWWW++WWWWWWWWWWWW
**********BGGGGGGGGGGGGG===GGGGGSGGGGGGGGGGGGGGGGGGGGGGGGGGGGGGB
*********BGGGGGGGGGGGGGG===GGGGGGGGGGGGGGGGGGGGGGSGGGGGGGGGGGGGB
*********BGGGGGGGGGGGGGGWWWGGGGGGGGGGGGSGGGGGGGGGGGGGGGGBBBBBBBB
**********BGGGGGGGGGGGGGWWWGGGGGGGGGGGGGGGGGGGGGGGGGGGGB********
***********BBBBBBBBBBBBBWWWBBBBBBBBBBBBBBBBBBBBBBBBBBBB********