****************************************************************************
****************************************************************************
*BBBBBBBBBBBBBBBBBBBBBBBBBBBBBBBBBBBBBBBB***********************************
*BPGGGGGGGGGGGGGGGGGGGGGGGGGGGGGGGGGBBBBBBBBBBBBBBBBB***********************
*BGGGGGGGGGGGGGGGGGGGGGGGGGGGGGGGGGGGGGGGGGGGGGGGGGGGBBBBBBBBBB*************
*BGGGGGGBBBBBBBBBGGGGGGGGGGGGGGGGGGGGGGGGGGGGGGGGGGGGGGGGGGGGGB*************
*BGGGGGGBGGGGGGGBGGGGGGGGGGGGGGGGBBBBBBBBBBBBBGGGGGGGGGGGGGGGGB*************
*BGGGGGGBGGGGGGGBBBBBBBBBBGGGGGGGGBGGGGGGGGGGGBGGGGGGGGGGGGGGGB*************
*BGGGGGGBGGGGGGGGGGGGGGGGBGGGGGGGGGBGGGGGGGGGGGBBBBBBBGGGGGGGGGBBBBBBBBBB***
*BGGGGGGBGGGGGGGGGGGGGGGGBGGGGGGGGGGBGGGGGGGGGGGGGGGGBGGGGGGGGBGGGGGGGGGB***
*BGGGGGGBBBBBBBBGGGGGGGGGGBGGGGGGGGGGBGGGGGGGGGGGGGGGBGGGGGGGGBGGGGGGGGGB***
*BGGGGGGGGGGGGGGBGGGGGGGGGGBGGGGGGGGGBGGGGBBBBBBBBBBBBGGGGGGGBGGGGGGGGGGB***
**BGGGGGGGGGGGGGBGGGGGGGGGGGGGGGGGGGGBGGGGGGGGGGGGGGGGGGGGGGGGGGGGGGGGGGB***
***BBBBBBBBBBBBBBBBBGGGGGGGGGGGGGGGGGBGGGGGGGGGGGGGGGGGGGGGGGGGGGGGGGGPGB***
********************BBBBBBBBBBBBBBBBBBBBBBBBBBBBBBBBBBBBBBBBBBBBBBBBBBBB****
