GTGGTGTGTGGTGTGTGTGTGGTGTGTGGTGTGTGTGGTGTGTGTGGTGTGTGGTGTGGTGTGTGGTGTGGTGTTGGTG
GGTGGGGTGTGTGTGTGTGTGTGTGTGTGTGTGTGTGTGTGTGTGTGTGTGTGTGTGTGTGGTGTGGTTGTGTGTGTGG
GGGTGTTGGTGTGTGTGGTGTGTGTGGTGTGTGGTGTGTGTGTGGTGTGGTGTGTGGTGTGTGGTGTGTGTGGTGGGGG
GGTGGTGGGGGGGGGGGGGGGGGGGGGGGGGGGGGGGGGGGGGGGGGGGGGGGGGGGGGGGGGGGGGGGGGGGTGGTGG
GGGTGGGGGGGGGGGGGGGGGGGGGGGGGGGGGGGGGGGGGGGGGGGGGGGGGGGGGGGGGGGGGGGGGGGGTGTGGTG
GGGTTGGGGGGGSGGGGGGGGGGGGGGGSGGGGGGGSGGGGGGGGGGGGSGGGGGGGGSGGGGGGGGGGGGGGTGTGGT
GGGGGTGGGGGSGGGGGGGGGGGGGGGGGGGGGGGGGGGGGGGGGGGGGGGGGGGGGGGGGGGGGSGGGGGTGGTGTGG
TGGTGTGGGGGGGGGGGGGGGGGGGGGGGGGGGGGGGGGGGGGGGGGGGGGGGGGGGGGGGGGGGGGGGGGGTGGTGTG
GTGGGTGGGGGGGGGGGTGGTGTGGTGTGTGGTGTGTGGTGTGTGTGTGTGGTTGGTGTGTGGGGGGGGGGGGTGGTGT
GGTTGGTGGGGGGGGGGGTGTGTGTGTGGTTGGTGTGGTGTGTGTGTGGTGTGTGTGGTGTGTGGGGGGGGGTGGTGTG
GGGGTTGGGGGSGGGGGTGGGGGGGGGGGGGGGGGGGGGGGGGGGGGGGGGGGGGGGGGGGTGGGGGGGGGGGTTGGGG
GTGTGGTGGGGGGGGGGGGTGGGGGGGGGGGGGGGGGGGGGGGGGGGGGGGGGGGGGGGGTGTGGGGGGGGGGTGTTGG
GGGGTTGGGGGGGGGGGTGGGGGGGGGGGGGGGGGGGGGGGGGGGGGGGGGGGGGGGGGTGTGGGGGGGGGGGTGGTGG
GTGGTGTGGGGSGGGGGGTGGGGGGSGGGGGGGSGGGGGGGGGGGGGGGGGGbGGGGGGGTGGGGGGGGGGGGGGGGTG
GGTTGTGGGGGGGGGGGTGGGGGGGGGGGGGGGGGGGGGGGGGGGGGGGGGGGGGGGGGTGGGGGGGSGGGGGTGGTGG
GGGTTGGGGGGGGGGGGGTGGGGGGGGGGGGGGGGGGGGGGGGGGGGGGGGGGGGGGGGGTGGGGGGGGGGGTGGTGGG
GTGGGTGGGGGGGGGGGTGGGGGGGGGGGGGGGGTGTGGTGTGTGGTGTGTGTGTGGTTTGGGGGGGGGGGGGGGGGGG
GTGGTTGGGGGGGGGTGGTGGGGGSGGGGGGGGGGTGGTGTGTGGTGTGTGTGGTGTGTTTGGGGGGGGGGGGGGTTGG
GTGGGGGGGGGGGGGGGTGGGGGGGGGGGGGGGGGGGGGGGGGGGGGGGGGGGGGGGGGGTGGGGGGGGGGGGTGTGGG
GGTGTGGGGGGGGGGGGGGGGGGGGGGGGGGGGGGGGGGGGGGGGGGGGGGGGGGGGGGGGGGGGGGSGGGGGGGGGGG
GGT|GGGGpGGGGGGGTGGGGGGGGGGGGGGGGGGGGGGGGGGGGGGGGGGGGGGGGGGGGGGGGGGGGGGGGGTTGGG
GGG|GGGGGGGGGGGGGTGGGGGGGSGGGGGSGGGGGGGGGGGGGGGGGGGSGGGGGGGGGGGGGGGGSGGGGGGGGGG
GGG|GGGGGGGGGGGGGGTGGGGGGGGGGGGGGGGGGGGGGGGGGGGGGGGGGGGGGGGGGGGGGGGGGGGGGGTGGGG
GGG-----<>------TGGGGGGGGGGGGGGGGGGGGGGGGGGGGGGGGGGGGGGGGGGGGGGGGGGGGGGGGGGTGGG
GGGGGGGGGGGGGGGGGTGGGTGGTGGTGGGTGGTGGTGTGGTGGTGTGTGGTGTGTGTGGTGTGGTGTGTGGTGTTTG
GGGGGGGGGGGGGGGGTGTGGGTGGTGTGTGGTGTGTGGTTGGGGTGTGGTGGGTGGGGTGGTGGGGTGTGTGGGGTGG
GGGGGGGGGGGGGGGGGGGTGTGGTGTGTGGTGTGTGTGTGTGTGGTGTGGTGTGGTGGGGTGGGTGGTGTGGTGTGGG
GGGGGGGGGGGGGGGGTGGGTGGTGGTGTGGTGTGGTTGTGGGGTGGGGTGGGGGGGTGGGGGGGGTGGGGGGGTGGTG
