BBBBBBBBBBBBBBBBBBBBBBBBBBB
BGGGGGGGGGGGGGGGGGGGGGGGGGB
BGGGGPGGGGGGGGGGGGGGGGGGGGB
BGGGGGGGGGGGGGGGGGGGGGGGGGB
BGGGGGGGGGGGGGGGGGGGGGGGGGB
BGGGGGGGGGGGGGGGGGGGGGGGGGB
BGGGGGGGGGGGGGGGGGGGGGGGGGB
BGGGGGGGGGGGGGGGGGGGGGGGGGB
BGGGGGGGGGGGGGGGGGGGGGGGGGB
BGGGGGGGGGGGGGGGGGGGGGGGGGB
BGGGGGGGGGGGGGGGGGGGGGGGGGB
BGGGGGGGGGGGGGGGGGGGGGGGGGB
BGGGGGGGGGGGGGGGGGGGGGGGGGB
BGGGGGGGGGGGGMHHHHHHHHHHHHB
BGGGGGGGGGGGGVDDDDDDDDDDDDB
BGGGGGGGGGGGGVDDDDDDDDDDDDB
BGGGGGGGGGGGGVDDDDDDDDDDDDB
BGGGGGGGGGGGGVDDDDDDDDDDDDB
BGGGGGGGGGGGGVDDDDDDDDDDDDB
BBBBBBBBBBBBBBBBBBBBBBBBBBB