DBBBBBDBBBBBBDBBBBBBDBBBBBBD
BGGGGGGGGGGGGGGGGGGGGGGGGGGB
BGGGGGGGGGGGGGGGGGGGGGGGGGGB
BGGGGGGGGGGGGGGGGGGGGGGGGGGB
BGGGGGGGGGGGGGGGGGGGGGGGGGGB
DGGGGGDGGGGGGDGGGGGGDGGGGGGB
BGGGGGGGGGGGGGGGGGGGGGGGGGGB
BGGGGGGGGGGGGGGGGGGGGGGGGGGB
BGGGGGGGGGGGGGGGGGGGGGGGGGGB
BGGGGGGGGGGGGGGGGGGGGGGGGGGB
DGGGGGDGGGGGGDGGGGGGDGGGGGGB
BGGGGGGGGGGGGGGGGGGGGGGGGGGB
BGGGGGGGGGGGGGGGGGGGGGGGGGGB
BGGGGGGGGGGGGMHHHHHHHHHHHHHB
BGGGGGGGGGGGGVDDDDDDDDDDDDDB
DGGGGGDGGGGGGBDDDDDDGDDDDDDB
BGGGGGGGGGGGGVDDDDDDDDDDDDDB
BGGGGGGGGGGGGVDDDDDDDDDDDDDB
BGGGGGGGGGGGGVDDDDDDDDDDDDDB
BBBBBBBBBBBBBBBBBBBBBBBBBBBB