GGGGGGGGGGGGGGGGGGGGGGGGG
GGGGGGGGGGGGGGGGGGGGGGGGG
GGGGGGGGGGGGGGGGGGGGGGGGG
GGGGGGGGGGGGGGGGGGGGGGGGG
GGGGGGGGGGGGGGGGGGGGGGGGG
GGGGGGGGGGGGGGGGGGGGGGGGG
GGGGGGGGGGGGGGGGGGGGGGGGG
GGGGGGGGGGGGGGGGGGGGGGGGG
GGGGGGGGGGGGGGGGGGGGGGGGG
GGGGGGGGGGGGGGGGGGGGGGGGG
GGGGGGGGGGGGGGGGGGGGGGGGG
GGGGGGGGGGGGGGGGGGGGGGGGG
GGGGGGGGGGGGMHHHHHHHHHHHH
GGGGGGGGGGGGVDDDDDDDDDDDD
GGGGGGGGGGGGVDDDDDDDDDDDD
GGGGGGGGGGGGVDDDDDDDDDDDD
GGGGGGGGGGGGVDDDDDDDDDDDD
GGGGGGGGGGGGVDDDDDDDDDDDD