HBBBBBBBBBBBBBBBBBBBBBBBBBD
MGGGGGGGGGGGGGGGGGGGGGGGGGV
MGGGGPGGGGGGGGGGGGGGGGGGGGV
MGGGGGGGGGGGGGGGGGGGGGGGGGV
MGGGGGGGGGGGGGGGGGGGGGGGGGV
MGGGGGGGGGGGGGGGGGGGGGGGGGV
MGGGGGGGGGGGGGGGGGGGGGGGGGV
MGGGGGGGGGGGGGGGGGGGGGGGGGV
MGGGGGGGGGGGGGGGGGGGGGGGGGV
MGGGGGGGGGGGGGGGGGGGGGGGGGV
MGGGGGGGGGGGGGGGGGGGGGGGGGV
MGGGGGGGGGGGGGGGGGGGGGGGGGV
HBBBBBBBBBBBBBBBBBBBBBBBBBD