BBBBBBBBBBBBBBBBBBBBBBBBBBBB
BGGGGGGGGGGGGGGGGGGGGGGGGGGB
BGGGGGGGGGGGGGGGGGGGGGGGGGGB
BGGGGGGGGGGGGGGGGGGGGGGGGGGB
BGGGGGGGGGGGGGGGGGGGGGGGGGGB
BGGGGGGGGGGGGGGGGGGGGGGGGGGB
BGGGGGGGGGGGGGGGGGGGGGGGGGGB
BGGGGGGGGGGGGGGGGGGGGGGGGGGB
BGGGGGGGGGGGGGGGGGGGGGGGGGGB
BGGGGGGGGGGGGGGGGGGGGGGGGGGB
BGGGGGGGGGGGGGGGGGGGGGGGGGGB
BGGGGGGGGGGGGGGGGGGGGGGGGGGB
BGGGGGGGGGGGGGGGGGGGGGGGGGGB
BGGGGGGGGGGGGMHHHHHHHHHHHHHB
BGGGGGGGGGGGGVDDDDDDDDDDDDDB
BGGGGGGGGGGGGVDDDDDDDDDDDDDB
BGGGGGGGGGGGGVDDDDDDDDDDDDDB
BGGGGGGGGGGGGVDDDDDDDDDDDDDB
BGGGGGGGGGGGGVDDDDDDDDDDDDDB
BBBBBBBBBBBBBBBBBBBBBBBBBBBB