BBBBBBBBBBBBBBBBBBBBBBBBBBBB
BGGGGGGGGGGGGGGGGGGGGGGGGGGB
BGGGGGGGGGGGGGGGGGGGGGGGGGGB
BGGGGGGGGGGGGGGGGGGGGGGGGGGB
BGGGGGGGGGGGGGGGGGGGGGGGGGGB
BGGGGGDGGGGGGDGGGGGGDGGGGGGB
BGGGGGGGGGGGGGGGGGGGGGGGGGGB
BGGGGGGGGGGGGGGGGGGGGGGGGGGB
BGGGGGGGGGGGGGGGGGGGGGGGGGGB
BGGGGGGGGGGGGGGGGGGGGGGGGGGB
BGGGGGDGGGGGGDGGGGGGDGGGGGGB
BGGGGGGGGGGGGGGGGGGGGGGGGGGB
BGGGGGGGGGGGGGGGGGGGGGGGGGGB
BGGGGGGGGGGGGMHHHHHHHHHHHHHB
BGGGGGGGGGGGGVDDDDDDDDDDDDDB
BGGGGGDGGGGGGBDDDDDDGDDDDDDB
BGGGGGGGGGGGGVDDDDDDDDDDDDDB
BGGGGGGGGGGGGVDDDDDDDDDDDDDB
BGGGGGGGGGGGGVDDDDDDDDDDDDDB
BBBBBBBBBBBBBBBBBBBBBBBBBBBB