BCCCCCCCCCCCCCCCCCCCCCCCCCCCCCCCCCCCCCCCCCCCCCCCCCCCCCCCCCCCCC|WWWWWWWWWWWWWWWWWWWWWWWWWWWWWWWWWWWWWWWWWWWWWWWWWWWWWWWWWWWW)GTGGGGGGGGGGGGTGGGGGGGGGGGGGGGGGGB
BCCCCCCCCCCCCCCCCCCCCCCCCCCCCCCCCCCCCCCCCCCCCCCCCCCCCCCCCCCCCC|WWWWWWWWWWWWWWWWWWWWWWWWWWWWWWWWWWWWWWWWWWWWWWWWWWWWWWWWWWW)GGGTGGGGGGTGGGTGGTGGGGGTGGTGTTTTGGB
B-------------------------|CCCCCCCCCCCCCCCCCCCCCCCCCCCCCCCCCCC|WWWWWWWWWWWWWWWWWWWWWWWWWWWWWWWWWWWWWWWWWWWWWWWWWWWWWWWWWW)GTGGGTGGGGTGGTGGGTGTGGGTGGGGTGGTTTGB
BWWWWWWWWWWWWWWWWWWWWWWWWW|CCCCCCCCCCCCCCCCCCCCCCCCCCCCCCCCCCC|WWWWWWWWWWWWWWWWWWWWWWWWWWWWWWWWWWWWWWWWWWWWWWWWWWWWWWWWW)GGGGGGGGGGGTGTGGGGGGGTGGGGGGGGTGTGGGB
BWWWWWWWWWWWWWWWWWWWWWWWWW|CCCCCCCCCCCCCCCCCCCCCCCCC|----------WWWWWWWWWWWWWWWWWWWWWWWWWWWWWWWWWWWWWWWWWWWWWWWWWWWWWWWW)GTGGGTGTGTGTTGGGGGTTGGGGTTGGGGGGGGGTTB
BWWWWWWWWWWWWWWWWWWWWWWWWW|CCCCCCCCCCCCCCCCCCCCCCCCC|WWWWWWWWWWWWWWWWWWWWWWWWWWWWWWWWWWWWWWWWWWWWWWWWWWWWWWWWWWWWWWWWW)GGGGGGGGGGGTGGGGTGGTGGGTGTTGTTTTTTGGTTB
BWWWWWWWWWWWWWWWWWWWWWWWWW|CCCCCCCCCCCCCCCCCCCCCCCCC|WWWWWWWWWWWWWWWWWWWWWWWWWWWWWWWWWWWWWWWWWWWWWWWWWWWWWWWWWWWWWWWW)GGTTGTGTTGGGGTGGGGGGGTGGGGGGGGGGGGGTTTWB
BWWWWWWWWWWWWWWWWWWWWWWWWW-----------|CCCCCCCCCCCCCC|WWWWWWWWWWWWWWWWWWWWWWWWWWWWWWWWWWWWWWWWWWWWWWWWWWWWWWWWWWWWWWW)GTTTTGGGGGGGGGTTTTGGGGGGGGGGGGTGTTGTTTTTB
BWWWWWWWWWWWWWWWWWWWWWWWWWWWWWWWWWWWW|CCCCCCCCCCCCCC|WWWzZ(WWWWWWWWWWWWWWWWWWWWWWWWWWWWWWWWWWWWWWWWWWWWWWWWWWWWWWWT)TGGGGGGGGGGGGGGGGGGGGGGGGGGGGGGTTGTTGTTTTB
BWWWWWWWWWWWWWWWWWWWWWWWWWWWWWWWWWWWW|CCCCCCCCCCCCCC|WWWlGGZuZWWWWWWWWWWWWWWWWWWWWWWWWWWWWWWWWWWWWWWWWWWWWWWWWWWWW)TGGGGTTTTTTTTTGGGTTTTGGTTTGGGGGSGTTGTTGTTTB
BWWWWWWWWWWWWWWWWWWWWWWWWWWWWWWWWWWWW|CCCCCCCCCCCCCC|WWWlGGGGGZuuuuuuuZWWWWzuuuuuuuuuuuuuuuuuuuuuuuuuuuuuuuuuuuuuzTGTGGGGTGGGGGGGGGGGGTGGGGTGTGGGGGTGTTGTTGTTB
BuuuuuuuuuuuuuuuuuuuuuuuuuuuuuuZWWWWW|CCCCCCCCCCCCCC|WWWlGGGGGGGGGGGGGLWWWWlGGGGGGGGGGGGGGGGGGGGGGGGGGGGGGGGGGGGGGGGTTTGGGGGGGTTTTTTGTTTGTTTGGTGGGGTTGTTGTTGTB
BGGGGGGGGGGGGGGTGGTGGGGGGGGGGGGG(WWWW------[]--------WWWlGGGGGGGGGGGGGLWWWWlGGGGGGGGGGGGGGGGGGGGGGGGGGGGGGGGGGGGGGGGGGTTGGTTTGTGTGGGTGGGTGTGGGGTGGGGTTGTTGTTTB
BGGGGGGGGGGTGGTGGGGGGGGGGGGGGGGGG(WWWWWWWWW++WWWWWWWWWW)GGGGGGNVVVVVVV======VVVVVVVVVVVVVVnGGGGGGGGGGGGGGGGGGdGGGGGGGGGGTGGTGGGGGTGGGGTGGTGTGGTTTGGTGTTGTTGTTB
BGGGGGGGGGGGGGGTGGGGGGGGGGGGGGGGGGZuuuuuuuu++uuuuuuuuuzGGGGGGGVVVVVVVV======VVVVVVVVVVVVVVV@GGGGGGGGGGGGGGGGGGGGGGGGGGGGGGTGTGTTTTTTGTGGGGTGGGGGGTGTTGTTGTTGTB
BGGGGGGGGGGTGGGGTGTGGGGGGGGGGGGGGGGGGGGGGGGjjGGGGGGGGGGGGGGGGGVVGGGGGGLWWWWlGGGGGGGGGGGGGVVGGGGGGGGGGGGGGGGGGGGGGGGGGGGGGGGGTGGGGGGGGGTGGTGTTGTGGGTGTGGTTGTTTB
BGGGGGGGGGGGGGGTGGGGGGGGGGGGGGGGGGGGGG#GGGGVVGGGG#GGGGGGGGGGGGVVGGGGGGLWWWWlGGGGGGGGGGGGGVVGGGGGGGGGGGGGGGGGGGGGGGGGGGGGGGGGGGTGGGGGTTTTTTTTTTTGGGTTTGTGTTGTTB
BGGGGGGGGGGGGGGGTTGGGGGGGGGGGGGGGGSGGGGGGGGVVGGGGGGGGGGGGGGGGGVVGGGGGGLWWWWlGGGGGGGGGGGGGVVG#GGGGGGGGGGGGGGGGGG@GGGGGGGGGGGGGGGGTGGGGGTGGGGGGGGGGGGGTGTGGTTGTB
BGGGGGGGGGGGTTTGGGGGGGGGGGGGGGGGGGGGGGGGGGGVVGGGGGGGGGGGGGGGGGVVGGGGGGLWWWWlGGGGGGGGGGGGGVVGGGGGGGGGGGGGGGGGGGGGGGGGGGGGGGGGGGGGGGTGGGGTGTGGTGGTGGGGTGTGTGTTTB
BGGGGGGGGGGGGGGTGGGGGGGGGGGGGGGGGGGGGGGGGGGVVGGGGGGGGGNVVVVVVVVoGGGGGGLWWWWlGGGGGGGGGGGGGVVGGGGGGGGGGGGGGSGGGGGGGGGGGGGGGGGGGGGGGGGGTGGGGGGGGGTGGGGGTGTGGTGTTB
BGGGGGGGGGGGGGTGGGTGGGGGGGGGGGGGGGGGGGGGGGGVVGGGGGGGGNVVVVVVVVoGGGGGGGLWWWWlGGGGGGGGGGGGGVVGGGGGGGGGGGGGGGGGGGGGGGGGGGGGGGGGGGGGGGGG|GGGGTGTGGGGGGGTGTGTGTGGTB
BGGGGGGGGGGGGGGGTGGGGGGGGGGGGGGGGGGGGGGGGGGVVVVVVVVVVVoGGGGGSGGGGGGGGGLWWWWlGGGGGGGGGGGGGVVGGGGGGGGG#GGGGGGGGGGGGGGGGGGGGGGGGGGGGGGG|GGGTGTGTTTTTTTTTTGTTTTTGB
BGGGGGGGGGGGGGGTTGGGGGGGGGGGGGGGGGGGGGGGGGGOVVVVVVVVoGGGGGGGGGGGGGGGGGLWWWWlGGGGGGGGGGGGGVVGG@GGGGGGGGGGGGGGGGGGGGGGGGGGGGGGG@GGGGGG--<>--TGGGGGGGGGTTTGTTTTGB
BGGGGGGGGGGGGTGGGGTGGGGGGGGGGGGGGGGGGGGGGGGG@GGGGGVVGGGGG@GGGGGGGGGGGGLWWWWlGGGGGGGGGGGGGVVVVVVVVVVVVVVVVVVVVnGGGGGGGGGGGGGGGGGGGGGGGGiiGGTTGGGGGGTTGTTTGTTGTB
BGGGGGGGGGGGGGTGGGGGGGG@GGGGGGGdGGGGGGGGGGGGGGGGGGVVGGGGGGGGGGGGGGGGGGLWWWWlGGGGGGGGGGGGGVVVVVVVVVVV@VVVVVVVVVGGGGGGGGGGGGGGGGGGGGGGGGGGGGGGTGGGTTGTTGTTTGTTTB
BGGGGGGGGGGGGGGTGGGGGGGGGGGGGGGGGGGGGGGGGGGGGGGGGGVVGGGGGGGGGGGGGGGGGGLWWWWlGGGGGGGGGGGGGVVGGGGGGGGGGGGGGGGGVVGGGGGGGGGGGGGGGGGGGGGGGGGGGGTTGTGGTGGGGTGTGTTTTB
BGGGGGGGGGGGGGGGGGTGGGGGGGGGGGGGGGGGGGGGGGGGGGGGGGVVG#GGGGGGGGGGGGGGGGLWWWWlGGGGGGGGGGGGGVVGGGGGGGGGGGGGGGGGVVGGGGGGGGGGGGGGGGGGG@GGGGGGGGGTGGTTGTGGGGTGTGTTTB
BGGGGGGGGGGGGGGTGGGGGGGGGGGGGGGGGGGGGGGGGGGGGGGGGGVVGGGGGGGGGGGGGGGGGGLWWWWlGGGGGGGGGGGGGVVGGGGGdGGGGGGGGGGGVVGGGGGGGGGGGGGGGGGGGGGGGGGGGGTGTTTGGGGGGGGTTTGTTB
BGGGGGGGGGGGGTGGGGTGGGGGGGGGGGGGGGGGGGGGGGGGGGGGGGVVSGGGGGGGGGGGGGGGGGG(WWWW;GGGGGGGGGGGGVVGGGGGGGGGGGGGGGGGVVGGGGGGGSGGGGGGGGGGGGGGGGGGSGGTGGGTGGTGGGTGTTTGTB
BGGGGGGGGGGGTGTGGGGGGGGGGGGGGGGGGGGGGGGGGGGGGGGGGGVVGGGGGGGGGGGGGGGGGGGG(WWWW;GGGGGGGGGGGVVGGGGGGGGGGGGGGGGGVVGGGGGGGGGGGGGGGGGGGGGGGGGGGGTGTTGGTGGTGGTTGTTTGB
BGGGGGGGGGGGGGGTGTGTGGGGGGGGG#GGGGGGGGGGGGGGGGGGGGVVGGGGGGG@GGGGGGGGGGGGG(WWWW;GGGGNVVVVVVVGGGGGGGGGGGGGGGGGVVGGGGGGGGGGGGGGGGGGGGGGGGGGGGGTGGTTGTGTTGTTTGTTTB
BGGGGGGGGGGGGGGGGGGGGGGGGGGGGGGGGGGGGGGGGGGGGGGGGGVVVVVVVVVVVVVVVVVVVVVVVV======VVVVVVVVVVGGGGGGGGGGG@GGGGGGVVGGGGGGGGGGGGGGGGGGGGGGGGGGGGGTGGGTGGTGGTGTTTGTTB
BGGGGGGGGGGGGTGGTGGTGGGGGGGGGGGGGGGGGGGGGGGGGGGGGGOVVVVVVVVVVVVVVVVVVVVVVVV======VVVVoGGGGGGGGGGGGGGGGGGGGGGVVGGGGGGGGGGGGGGGGGGGGGGGGGGGGGGGGTGTGGTTGTGTTTGTB
BGGGGGGGGGGTGGTGGGGGGGGGGGGGGGGGGGGGGGGGGGG#GGGGGGGGGGGGGVVGGGGGGGGGGGGGGGGG(WWWW;GGGGGGGGGGGGGGGGGGGGGGGGGGVVnGGGGGGGGGGGGGGGGGGGGGGGGGGGGTTTGGGGGTGGTTGTTTGB
BGGGGGGGGGGGGGGGGGGGGGSGGGGGGGGGGGGGGGGGGGGGGGGGGGGGGGGSGVVGGGGGGGGGGGGGGGGGG(WWWW;GGGGGGGGGGGGGGGGGS#GGGGGGOVVGGGGGGGGG@GGGGGGGGGGGGGGGGGGGTTGGGTGGGGTTTGTTTB
BGGGGGGGGGGGTGTGGGGTGGGGGGGGGGGGGGGGGGGGGGGGGGGGGGGGGGGGGVVGGGGGGGGGGGGGGGGGGG(WWWW;GGGGGGGGGGGG@GGGGGGGGGGGGVVGGGGGGGGGGGGGGGGGGGGGGGGGGGGTGGTTTTTGGTGTTTGTTB
BGGGGGGGGGGTGGTGGGGGGGGGG#GGGGGGGGGGGGGGGGGGGGGGGGGGGGGG@VVGGGGGGGGGGGGGGGGGGGG(WWWW;GGGGGGGGGGGGGGGGGGGGGGGNVVnGdGGGGGGGGGGGGGGGGGGGGGGGGGGTGGTGGGGGTTGTTTGTB
BGGGGGGGGGGGGTGGGGGGGGGGGGGGGGGGGGGGGGGGGGGGGGGGGGGGGGGGGVVGGGGGGGGGGGGGGGGGGGGG(WWWW;GGGGGGGGGGGGGGGGGGGGGNVVVVnGGGGGGGGGGGGGGGGGGGGGGGGGGTGGGGGGGGTGGTGTTTTB
BGGGGGGGGGGGGGTGGGGGTGGGGGGGGGGGGGGGGGGGGGGG#GGGGGGGGGGGGVVGGGGGGGGGGGGGGGGGGGGGG(WWWW;GGGGGGGGGGGGGGGGGGGNVVoOVVnGGGGGGGGGGGGGGGGGGGGGGGGGGGTGGTGGTGGGTGGTGGB
BGGGGGGGGGGGTGGTGTGGGGGGGGGGGGGGGGGGGGGGGGGGGGGGGGGGGGGGGVVGGGGGGGGGGGGGGGGGGGGGGG(WWWW;GGGGGGGGGGGGSGGGGNVVoGGOVVnGGGGGGGGGGGGGGGGGGGGGGGGGGGTGGTTGGGTGGTGGTB
BGGGGGGGGGGGGGGGGGGTGGGGGGGGGGGGGGGGGGGGGGGGGGGGGGGGGGGGGVVGGGGGGGGGGGGGGGGGGGGGGGG(WWWW;GGGGGGGG@GGGGGGNVVoGGGGOVVnGGGGGGGGGGGGGGGGGGGGGGGGTGGTGTGGGGGGTGGTGB
BGGGGGGGGGGGTGGTGGGGGGGGGGGGGGGGGGGGGGGGGGGGGGGGGGGGGGGGGVVGGGGGGGGGGGGGGGGGGGGGGGGGLWWWW;GGGGGGGGGGGGGNVVoGGGGGGOVVnSGGGGGGGGGGGGGGGGGGGGGGGGGGTGGGGGTGTGTGGB
BGGGGGGGGGGGGGGGGGGTGGGGGGGGGGGGGGGGGGGGGGGGGGGGGGGGGGGGGVVGGGGGGGGGGGGGGGGGGGGGGGG/WWWWWW;GGGGGGGGGGGNVVoGGGGGGGGOVVnGGGGGGGGGGGGGGSGGGGGGGGGGGGTGGGGGTGGTGTB
BGGGGGGGGGGTGGGGTGGGTGGGGGGGGGGGGGGGGGGGGGGGGGGGGGGGGGGGGVVGGGGGGGGGGGGGGGGGGGGGGG/WWWWWWWW;GGGGGGGGGNVVo@GGGGGGGG@OVVnGGGGGGGGGGGGGGGGGGGGGGGGGGGGGGGTGTGTGGB
BGGGGGGGGGGGGGTGGGGGGGGGGGGGGGGGGGGGGGGGGGGGGGGGGGGGGGGGGVVGGGGGGGGGGGGGGGGGGGGGG/WWWWWWWWWW;#GGGNVVVVVVVVVVVVVVVVVVVVVVVVVVVVVVVVVVVVVVVVVVVVVnGTGGGTGGGTGTGB
BGGGGGGGGGGGGGGGGGGGGGGGGGGGGGGGGGGGGGGGGGGGGGGGGGGGGGGGGVVGGGGGGGGGGGGGGGGGGGGG/WWWW)GG======VVVVVVVVVVVVVVVVVVVVVVVVVVVVVVVVVVVVVVVVVVVVVVVVVVGGTGTGTTTGTTTB
BGGGGGGGGGGGTGGGGTGTGGGGGGGGGGGGGGGGGGGG@GGGGGGGGGGGG@GGGVVGGGGGGGGGGGGGGGGGG@G/WWWW)GGGG======VVVV#GGGGGGGGGGGGGGGGVVGGGGGGGGGGGGGGGGGGGGGGGGVVGGGGGGGGGGGGGB
BGGGGGGGGGGGGGGTGGGGGGGGGGGGGGGGGGGGGGGGGGGGGGGGGGGGGGGGGVVGGGGGGGGGGGGGGGGGG#/WWWW)GGGGGG(WWWWyUUUUUUUUUUUUUUUUUUUU++UUUUUUUUUUUUUUUUUUUUUUUU++UUUUUUUUUUUUUB
BGGGGGGGGGGGGTGGTGTGGGGGGGGGGGGGGGGGGGGGGGGGGGGGGGGGGGGGGVVVVVVVVVVVVVVVVVVVV======GGGGG0GG(WWWWWWWWWWWWWWWWWWWWWWWW++WWWWWWWWWWWWWWWWWWWWWWWW++WWWWWWWWWWWWWB
BGGGGGGGGGGGTGGTGGGGTGTGGGGGGGGGGGGGGGGGGGGGGGGGGGGGGGGGGVVVVVVVVVVVVVVVVVVV======GGGGGpGGGG(WWWWWWWWWWWWWWWWWWWWWWW++WWWWWWWWWWWWWWWWWWWWWWWW++WWWWWWWWWWWWWB
BGGGGGGGGGGGGGGGGGGGGGGGGGGGGGGGGGGGGGGGGG#GGGGGGGGGGGGGGVVGGGGGGGGGGGGGGGGG@(WWWW;GGGGGGGGGGLWWWWWWWWWWWWWWWWWWWWWW++WWWWWWWWWWWWWWWWWWWWWWWW++WWWWWWWWWWWWWB
BUUUUUUUUUGGGGGGGGGGGGGGGGGGGGGGGGGGGGGGGGGGGGGGGGGGGGGGGVVGGGGGGGGGGGGGGG#GGG(WWWW;GGGGGGGGGLWWWWWWWWWWWWWWWWWWWWWW++WWWWWWWWWWWWWWWWWWWWWWWW++WWWWWWWWWWWWWB
BWWWWWWWWWaaaaaaaaaaaaaaaaaaa@GGGGGGGGGGGGGGGGGGGGGGGGGGGVVGGGGGGGGGGGGGGGGGGGG(WWWW;GGG1GGG/WWWWWWWWWWWWWWWWWWWWWWW++WWWWWWWWWWWWWWWWWWWWWWWW++WWWWWWWWWWWWWB
BWWWWWWWWWAGGGeGGGeGGGGeGGGGAGGGGGGGGGGGGGGGGGGGGGGGSGGGGVVGGGGGGGGGGGGGGGGGGGGG(WWWW;GGGGG/WWWWzuuuuuuuuuuuuuuuuuuu++uuuuuuuuuuuuuuuuuuuuuuuu++uuuuuuZWWWWWWB
BWWWWWWWWWAGeGGGGGGGGGGGGGGGAGGGGGGGGGGGGGGGGGGGGGGGG@GGGVVGGGGGGGGGGGGGGGGGGGGGG(WWWW;GGG======VnGGGGGGGGGGGGGGGGGGVVGGGGGGGGGGGGGGGGGGGGGGGGVVGGGGGGLWWWWWWB
BWWWWWWWWWAGGGGeGGGGGGGGGGGGAGGGGGGGNVVVVVVVVVVVVVVVVVVVVVVGGGGGdGGGGGGGGGGGGGGGGG(WWWW;G======VVVnGGGGGGGGGGGGGGGGGVVGGGGGGGGGGGGGGGGGGGGGGGGVVGGGGGGGZuuuuuB
BWWWWWWWWWAGeGGGGGGeGGGGGGGGcGGGGGGGVVVVVVVVVVVVVVVVVVVVVVoGGGGGGGGGGGGGGGG#GGGGGGG(WWWWWWWWWW)OVVVnGGGGGGGGGG@GGGGGVVGGGGGGGGGGGGGGGGGGGGGGGGVVGGGGGGQQQQQQQB
BWWWWWWWWWAGGGGGGGGGGGGGGGGGcGGGGGGGVVGGGGGGGGGGGGGGGGGGGGGGGGGGGGGGGGGGGGGGGGGGGGGG(WWWWWWWW)GGOVVVnGGGGGGGGGGGGGGGVVGGGGGGGGGGGGSGGGGGGGGGGGVVGGGGGGQDDDDDDB
BWWWWWWWWWAGeGGeGGGGGeGGGGGGAG@GGGGGVVGG#GGGGGGGGGGGGGGGGGGGGGGGGGGGGGGGGGGGGGGGGGGGG(WWWWWW)GGGGOVVVnGGGGGGGGGGGGGGVVGGGGGGGGGGGGGGGGGGGGGGGGVVGGGGGGQDDDDDDB
BWWWWWWWWWAGGGGGGGGGGGGGGGGGAGGGGGGGVVGGGGGGGGGGGGGGGGGSGGGGGGGGGGGGGGGGGGGGGGGGGGGGGGLWWWW)GGGGGGOVVVnGGG@GGGGGSGGGVVGGGGGGGG@GGGGGGGGGGGGGGGVVGGGGGGQDDDDDDB
BWWWWWWWWWAGeGGGGGGeGGGGGGGGAGGGGNVVVVGGGGGGGGGGGGGGGGGGGG@GGGGGGGGGGGGGGGGG@GGGGGGGG/WWWW)GGGGGGGGOVVVnGGGGGGGGGGGGVVGGGGGGGGGGGGGGGGGGGGGGGGVVGGGGGGQDDDDDDB
BWWWWWWWWWAGGGGGGGGGGGGGGGGGAGGGGVVVVoGGG#GGGGGGGGGGGGGGGGGGGGGGGGGGGGGGGGGGGGGGGGGG/WWWW)GGGGGGGGGGOVVVnGGGGGGGGGGGVVGGGGGGGGGGGGGG@@#GGGGGGGVVGGGGGGQDDDDDDB
BWWWWWWWWWaaaaaaaaaaaaaaaaaaaGGGGVVGGGGGGGGGGGGGGGGGGGGGGGGGGGGGGGGGGGGGGGGGGGGGGGG/WWWW)GGGGGGGGGGGGOVVVnGGGGG@GGGGVVGGGGGGGGGGGGGGGd@GGGGGGGVVGGGGGGQDDDDDDB
BWWWWWWWWWYUUUUUUUUUUUUUUUUUUUUUU++UUUUUUUUUUUUUUUUUUUUUUUUUUUUUUUUUU++UUUUUUUUUUUYWWWWzGGGGGGGGGGGGSGOVVVnGGGGGGGGGVVGGGGGGGGGGGGGGGGGGGGGGGGVVGGGGGGQDDDDDDB
BWWWWWWWWWWWWWWWWWWWWWWWWWWWWWWWW++WWWWWWWWWWWWWWWWWWWWWWWWWWWWWWWWWW++WWWWWWWWWWWWWWWWlGGGGGGGGGGGGGGGOVVVnGGGGGGGGVVGGGGGGGGGGGGGGGGGGGGGGGNVVGGGGGGQDDDDDDB
BWWWWWWWWWWWWWWWWWWWWWWWWWWWWWWWW++WWWWWWWWWWWWWWWWWWWWWWWWWWWWWWWWWW++WWWWWWWWWWWWWWWW)GGGGGGGGGGGG#GGGVVVVVVVVVVVVVVGGGGGGGGGGGGSGGGGGGGGGNVVoGGGGGGQDDDDDDB
BWWWWWWWWWWWWWWWWWWWWWWWWWWWWWWWW++WWWWWWWWWWWWWWWWWWWWWWWWWWWWWWWWWW++WWWWWWWWWWWWWWW)GGGGGGGGGGGGGGGGNVVVVVVVVVVVVVVGGGGGGGGGGGGGGGGGGGGGNVVoGGGGGGGQDDDDDDB
BWWWWWWWWWWWWWWWWWWWWWWWWWWWWWWWW++WWWWWWWWWWWWWWWWWWWWWWWWWWWWWWWWWW++WWWWWWWWWWWWWW)GGGGGGGGGGGGGGGGNVVVoGSGGG@GGVV##GGGGG@GGGGGGGGGGGGGNVVoGGGGGGGGQDDDDDDB
Buuuuuuuuuuuuuuuuuuuuuuuuuuuuuuuu++uuuuuuuuuuuuuuuuuuuuuuuuuuuuuuuuuu++uuuuuuuuuuuuuzGGGGGGGGGGGGGGGGNVVVoGGGGGGGGGVVGGGGGGGGGGGGGGGGGGGGNVVoGGGGGGGGGQDDDDDDB
B@@@@@@@@@aaaaaaaaGGGGGGGGGGGGGGGVVGGGGGGGGGGGGGGGGGGGGGGGGGGGGGGGGGGVVGGGGGGGGGGGGGGGGGGGGGGGGGGGGGNVVVoGGGGGGGGGGVVVVVVVVVVVVVVVVVVVV@VVVoGGGGGGGGGGQDDDDDDB
B@@@@@@@@@@@GGGGGAGGGGGGGGGGGGGGGVVGGGGGGGGGGGGGGGGGGGGGGGGGGGGGGGGGGV#GGGGGGGGGGGGGGGGGGGGGGG#GGGGNVVVoGGGGGGGGGGGOVVdVVVVVVVVVVVVVVVVVVVoGGGGGGGGGGQQDDDDDDB
B@@@@@@@@@@@GGGGGaaaaaGGGGGGGGGSGVVGGGG#GGGGSGGGGGGGGGGGGGGGGSNVVVVVVVVVVVVVVVVVVVVVVVVVVVVVVVVVVVVVVVoGGGGGGGGGGGGGGGGGGGGGGGGGGGGGGGGGGGGGGGGGGGGGQQDDDDDDDB
B@@@@@@@@@@@GGGGeGGGGcGGGGGGGGGGGVVnGGGGGGGGGGGGGGGGGGdGGGGGGNVVVVVVVVVVVVVVVVVVVVVVVVVVVVVVVVVVVVVVVoGGGGGGGGGGGGGGGGGGGGGGGGGGGGGGGGGGGGSGGGGGGGGQQDDDDDDDDB
B@@@@@@@@@@@GGeGGGGGGaaaaaaGGGGGGOVVGGGGGGGGGGGGGGGGGGGGGGGNVVVoGGGGGGGGGGGGGGGGGGGGGGGGGGGGGGGGGGGGGGGGGGGGGGGGGGGGGGGGGGGGGGGGGGGGGGGGGGGGGGGGGGQQQQQQQQQQQB
B@@@@@@@@@@@GGGGGGGGGGGGGGAGGGGGGGVVGGGGGGGGGGGGGGGGGGGGGGNVVoGGGGGGGGGGGGGG#GGGGG#GGGGGG#GGGGGGGGGGGGGGGGGGGGGGGGGGGGGGGGGGGGGGGGGGGGGGGGGGGGGGGQQDDDDDDDDDDB
B@@@@@@@@@@@@eGGGGGGGGGGGGAGGGGG#GVVVVVV@VVVVVVVVVVVVVVVVVVVoGGGGGGGG#GGGGGGGGGGGGGGGGGGGGGGGGGGGGGGGGGGGGGGGGGGGGGGGGGGGGGGGGGGGGGGGGGG@GGGGGGGGQDDDDDDDDDDDB
B@@@@@@@@@@@@GGGeGGGGGeGGGAGGGGGGGOVVVVVVVVVVVVVVVVVVVVVVVVoGGGGGGGGGGGGGGGGGGGGGGGGGGGGGGGGGGGGGGGGGGGGGGGGGGGGGGGGGGGGGGGGGGGGGGGGGGGGGGGGGGGGGQDDDDDDDDDDDB
B@@@@@@@@@@@@eGGGGGGGGGGGGAGGGGGGGGGGGGGGGGGGGGGGGGGGGGGGGGGGGGGGGGGGGGGGGGGGGGGGGGGGGGGGGGGGGGGGGGGGGGGGGGGGGGGGGGGGGGGGGGGGGGG@II@GGGGGGGGGGGGGQDDDDDDD$DDDB
BG@@@@@@@@@@@GGGGGGGGGGGGGA@@@@@GGGGG@@@@@@@@@@@@@@@@@@@@@@@@@@@@@@@@@@@QQQQQQQQQQQQQQQQQQQQQQQQQQQQQQQQQQQQQQQQQQQQQQQQQQQQQQQQQ{}QQQQQQQQQQQQQQQQQQQQQQQQQQB
BGG@@@@@@@@@@GGeGGGGeGGGGGA@@@@@@@@@@@@@@@@@@@@@@@@@@@@@@@@@@@@@@@@@@@QQDDDDDDDDDDDDDDDDDDDDDDDDDDDDDDDDDDDDDDDDDD$DDDDD$DDDDDDDDDDDDDDD$DDDDDDDDDDD$DDDDDDDDB
BGGG@@@@@@@@@@@@@@@@@@@@GGAGG@@@@@@@@@@@@@@@@@@@@@@@@@@@@@@@@@@@@@@@@QQDDDDDDDDDDDDDDDDDDDDDDDDDDDDDDDDDDDDDDDDDDDDDDDDDDD$DDDDDDDDDDDDDDDDDDDDDDDDDDDDDDDDDDB
BGGGGGGGGGGGGGGGGGGGGG@@@@@@@@@@@@@@@@@@@@@@@@@@@@@@@@@@@@@@@@@@@@@@QQDDDDDDDDDDDDDDDDDDDDDDDDDDDDDDDDDDDDDDDDD$DDDDDD$DDDDDDDDDDDDDDDDD$DDDDDDDDDDDDDDDDDDDDB
BGGGGGGGGGGGGGGGGGGGGG@@@@@@@@@@@@@@@@@@@@@@@@@@@@@@@@@@@@@@@@@@@@@@QQDDDDDDDDDDDDDDDDDDDDDDDDDDDDDDDDDDDDDDDDD$DDDDDD$DDDDDDDDDDDDDDDDD$DDDDDDDDDDDDDDDDDDDDB
BGGGGGGGGGGGGGGGGGGGGG@@@@@@@@@@@@@@@@@@@@@@@@@@@@@@@@@@@@@@@@@@@@@@QQDDDDDDDDDDDDDDDDDDDDDDDDDDDDDDDDDDDDDDDDD$DDDDDD$DDDDDDDDDDDDDDDDD$DDDDDDDDDDDDDDDDDDDDB
BGGGGGGGGGGGGGGGGGGGGG@@@@@@@@@@@@@@@@@@@@@@@@@@@@@@@@@@@@@@@@@@@@@@QQDDDDDDDDDDDDDDDDDDDDDDDDDDDDDDDDDDDDDDDDD$DDDDDD$DDDDDDDDDDDDDDDDDDDDDDDDDDDDDDDDDDDDDDB
BGGGGGGGGGGGGGGGGGGGGG@@@@@@@@@@@@@@@@@@@@@@@@@@@@@@@@@@@@@@@@@@@@@@QQDDDDDDDDDDDDDDDDDDDDDDDDDDDDDDDDDDDDDDDDD$DDDDDD$DDDDDDDDDDDDDDDDDDDDDDDDDDDDDDDDDDDDDDB
BGGGGGGGGGGGGGGGGGGGGG@@@@@@@@@@@@@@@@@@@@@@@@@@@@@@@@@@@@@@@@@@@@@@QQDDDDDDDDDDDDDDDDDDDDDDDDDDDDDDDDDDDDDDDDD$DDDDDD$DDDDDDDDDDDDDDDDDDDDDDDDDDDDDDDDDDDDDDB
BBBBBBBBBBBBBBBBBBBBBBBBBBBBBBBBBBBBBBBBBBBBBBBBBBBBBBBBBBBBBBBBBBBBBBBBBBBBBBBBBBBBBBBBBBBBBBBBBBBBBBBBBBBBBBBBBBBBBBBBBBBBBBBBBBBBBBBBBBBBBBBBBBBBBBBBBBBBBB