BCCCCCCCCCCCCCCCCCCCCCCCCCCCCCCCCCCCCCCCCCCC|WWWWWWWWWWWWWWWWWWWWWWWWWWWWWWWWWWWWWWWWWWWWWWWWWWWWWWWWWWWW)GTGGGGGGGGGGGGTGGGGGGGGGGGGGGGGGGB
BCCCCCCCCCCCCCCCCCCCCCCCCCCCCCCCCCCCCCCCCCCC|WWWWWWWWWWWWWWWWWWWWWWWWWWWWWWWWWWWWWWWWWWWWWWWWWWWWWWWWWWW)GGGTGGGGGGTGGGTGGTGGGGGTGGTGTTTTGGB
B-------|CCCCCCCCCCCCCCCCCCCCCCCCCCCCCCCCCCC|WWWWWWWWWWWWWWWWWWWWWWWWWWWWWWWWWWWWWWWWWWWWWWWWWWWWWWWWWW)GTGGGTGGGGTGGTGGGTGTGGGTGGGGTGGTTTGB
BWWWWWWW|CCCCCCCCCCCCCCCCCCCCCCCCCCCCCCCCCCC|WWWWWWWWWWWWWWWWWWWWWWWWWWWWWWWWWWWWWWWWWWWWWWWWWWWWWWWWW)GGGGGGGGGGGTGTGGGGGGGTGGGGGGGGTGTGGGB
BWWWWWWW|CCCCCCCCCCCCCCCCCCCCCCCCC|----------WWWWWWWWWWWWWWWWWWWWWWWWWWWWWWWWWWWWWWWWWWWWWWWWWWWWWWWW)GTGGGTGTGTGTTGGGGGTTGGGGTTGGGGGGGGGTTB
BWWWWWWW|CCCCCCCCCCCCCCCCCCCCCCCCC|WWWWWWWWWWWWWWWWWWWWWWWWWWWWWWWWWWWWWWWWWWWWWWWWWWWWWWWWWWWWWWWWW)GGGGGGGGGGGTGGGGTGGTGGGTGTTGTTTTTTGGTTB
BWWWWWWW|CCCCCCCCCCCCCCCCCCCCCCCCC|WWWWWWWWWWWWWWWWWWWWWWWWWWWWWWWWWWWWWWWWWWWWWWWWWWWWWWWWWWWWWWWW)GGTTGTGTTGGGGTGGGGGGGTGGGGGGGGGGGGGTTTWB
BWWWWWWW-----------|CCCCCCCCCCCCCC|WWWWWWWWWWWWWWWWWWWWWWWWWWWWWWWWWWWWWWWWWWWWWWWWWWWWWWWWWWWWWWW)GTTTTGGGGGGGGGTTTTGGGGGGGGGGGGTGTTGTTTTTB
BWWWWWWWWWWWWWWWWWW|CCCCCCCCCCCCCC|WWWzZ(WWWWWWWWWWWWWWWWWWWWWWWWWWWWWWWWWWWWWWWWWWWWWWWWWWWWWWWT)TGGGGGGGGGGGGGGGGGGGGGGGGGGGGGGTTGTTGTTTTB
BWWWWWWWWWWWWWWWWWW|CCCCCCCCCCCCCC|WWWlGGZuZWWWWWWWWWWWWWWWWWWWWWWWWWWWWWWWWWWWWWWWWWWWWWWWWWWWW)TGGGGTTTTTTTTTGGGTTTTGGTTTGGGGGSGTTGTTGTTTB
BWWWWWWWWWWWWWWWWWW|CCCCCCCCCCCCCC|WWWlGGGGGZuuuuuuuZWWWWzuuuuuuuuuuuuuuuuuuuuuuuuuuuuuuuuuuuuuzTGTGGGGTGGGGGGGGGGGGTGGGGTGTGGGGGTGTTGTTGTTB
BuuuuuuuuuuuuZWWWWW|CCCCCCCCCCCCCC|WWWlGGGGGGGGGGGGGLWWWWlGGGGGGGGGGGGGGGGGGGGGGGGGGGGGGGGGGGGGGGGTTTGGGGGGGTTTTTTGTTTGTTTGGTGGGGTTGTTGTTGTB
BGGGGGGGGGGGGG(WWWW------[]--------WWWlGGGGGGGGGGGGGLWWWWlGGGGGGGGGGGGGGGGGGGGGGGGGGGGGGGGGGGGGGGGGGTTGGTTTGTGTGGGTGGGTGTGGGGTGGGGTTGTTGTTTB
BGGGGGGGGGGGGGG(WWWWWWWWW++WWWWWWWWWW)GGGGGGNVVVVVVV======VVVVVVVVVVVVVVnGGGGGGGGGGGGGGGGGGdGGGGGGGGGGTGGTGGGGGTGGGGTGGTGTGGTTTGGTGTTGTTGTTB
BGGGGGGGGGGGGGGGZuuuuuuuu++uuuuuuuuuzGGGGGGGVVVVVVVV======VVVVVVVVVVVVVVV@GGGGGGGGGGGGGGGGGGGGGGGGGGGGGGTGTGTTTTTTGTGGGGTGGGGGGTGTTGTTGTTGTB
BGGGGGGGGGGGGGGGGGGGGGGGGVVGGGGGGGGGGGGGGGGGVVGGGGGGLWWWWlGGGGGGGGGGGGGVVGGGGGGGGGGGGGGGGGGGGGGGGGGGGGGGGGTGGGGGGGGGTGGTGTTGTGGGTGTGGTTGTTTB
BGGGGGGGGGGGGGGGGGGG#GGGGVVGGGG#GGGGGGGGGGGGVVGGGGGGLWWWWlGGGGGGGGGGGGGVVGGGGGGGGGGGGGGGGGGGGGGGGGGGGGGGGGGGTGGGGGTTTTTTTTTTTGGGTTTGTGTTGTTB
BGGGGGGGGGGGGGGGSGGGGGGGGVVGGGGGGGGGGGGGGGGGVVGGGGGGLWWWWlGGGGGGGGGGGGGVVG#GGGGGGGGGGGGGGGGGG@GGGGGGGGGGGGGGGGTGGGGGTGGGGGGGGGGGGGTGTGGTTGTB
BGGGGGGGGGGGGGGGGGGGGGGGGVVGGGGGGGGGGGGGGGGGVVGGGGGGLWWWWlGGGGGGGGGGGGGVVGGGGGGGGGGGGGGGGGGGGGGGGGGGGGGGGGGGGGGGTGGGGTGTGGTGGTGGGGTGTGTGTTTB
BGGGGGGGGGGGGGGGGGGGGGGGGVVGGGGGGGGGNVVVVVVVVoGGGGGGLWWWWlGGGGGGGGGGGGGVVGGGGGGGGGGGGGGSGGGGGGGGGGGGGGGGGGGGGGGGGGTGGGGGGGGGTGGGGGTGTGGTGTTB
BGGGGGGGGGGGGGGGGGGGGGGGGVVGGGGGGGGNVVVVVVVVoGGGGGGGLWWWWlGGGGGGGGGGGGGVVGGGGGGGGGGGGGGGGGGGGGGGGGGGGGGGGGGGGGGGGG|GGGGTGTGGGGGGGTGTGTGTGGTB
BGGGGGGGGGGGGGGGGGGGGGGGGVVVVVVVVVVVoGGGGGSGGGGGGGGGLWWWWlGGGGGGGGGGGGGVVGGGGGGGGG#GGGGGGGGGGGGGGGGGGGGGGGGGGGGGGG|GGGTGTGTTTTTTTTTTGTTTTTGB
BGGGGGGGGGGGGGGGGGGGGGGGGOVVVVVVVVoGGGGGGGGGGGGGGGGGLWWWWlGGGGGGGGGGGGGVVGG@GGGGGGGGGGGGGGGGGGGGGGGGGGGGGGG@GGGGGG--<>--TGGGGGGGGGTTTGTTTTGB
BGGGGGGGGGGGGGGGGGGGGGGGGG@GGGGGVVGGGGG@GGGGGGGGGGGGLWWWWlGGGGGGGGGGGGGVVVVVVVVVVVVVVVVVVVVnGGGGGGGGGGGGGGGGGGGGGGGGGGGGTTGGGGGGTTGTTTGTTGTB
BGGGG@GGGGGGGdGGGGGGGGGGGGGGGGGGVVGGGGGGGGGGGGGGGGGGLWWWWlGGGGGGGGGGGGGVVVVVVVVVVV@VVVVVVVVVGGGGGGGGGGGGGGGGGGGGGGGGGGGGGGTGGGTTGTTGTTTGTTTB
BGGGGGGGGGGGGGGGGGGGGGGGGGGGGGGGVVGGGGGGGGGGGGGGGGGGLWWWWlGGGGGGGGGGGGGVVGGGGGGGGGGGGGGGGGVVGGGGGGGGGGGGGGGGGGGGGGGGGGGGTTGTGGTGGGGTGTGTTTTB
BGGGGGGGGGGGGGGGGGGGGGGGGGGGGGGGVVG#GGGGGGGGGGGGGGGGLWWWWlGGGGGGGGGGGGGVVGGGGGGGGGGGGGGGGGVVGGGGGGGGGGGGGGGGGGG@GGGGGGGGGTGGTTGTGGGGTGTGTTTB
BGGGGGGGGGGGGGGGGGGGGGGGGGGGGGGGVVGGGGGGGGGGGGGGGGGGLWWWWlGGGGGGGGGGGGGVVGGGGGdGGGGGGGGGGGVVGGGGGGGGGGGGGGGGGGGGGGGGGGGGTGTTTGGGGGGGGTTTGTTB
BGGGGGGGGGGGGGGGGGGGGGGGGGGGGGGGVVSGGGGGGGGGGGGGGGGGG(WWWW;GGGGGGGGGGGGVVGGGGGGGGGGGGGGGGGVVGGGGGGGSGGGGGGGGGGGGGGGGGGSGGTGGGTGGTGGGTGTTTGTB
BGGSGGGGGGGGGGGGGGGGGGGGGGGGGGGGVVGGGGGGGGGGGGGGGGGGGG(WWWW;GGGGGGGGGGGVVGGGGGGGGGGGGGGGGGVVGGGGGGGGGGGGGGGGGGGGGGGGGGGGTGTTGGTGGTGGTTGTTTGB
BGGGGGGGGGG#GGGGGGGGGGGGGGGGGGGGVVGGGGGGG@GGGGGGGGGGGGG(WWWW;GGGGNVVVVVVVGGGGGGGGGGGGGGGGGVVGGGGGGGGGGGGGGGGGGGGGGGGGGGGGTGGTTGTGTTGTTTGTTTB
BGGGGGGGGGGGGGGGGGGGGGGGGGGGGGGGVVVVVVVVVVVVVVVVVVVVVVVV======VVVVVVVVVVGGGGGGGGGGG@GGGGGGVVGGGGGGGGGGGGGGGGGGGGGGGGGGGGGTGGGTGGTGGTGTTTGTTB
BGGGGGGGGGGGGGGGGGGGGGGGGGGGGGGGOVVVVVVVVVVVVVVVVVVVVVVVV======VVVVoGGGGGGGGGGGGGGGGGGGGGGVVGGGGGGGGGGGGGGGGGGGGGGGGGGGGGGGGTGTGGTTGTGTTTGTB
BGGGGGGGGGGGGGGGGGGGGGGGG#GGGGGGGGGGGGGVVGGGGGGGGGGGGGGGGG(WWWW;GGGGGGGGGGGGGGGGGGGGGGGGGGVVnGGGGGGGGGGGGGGGGGGGGGGGGGGGGTTTGGGGGTGGTTGTTTGB
BGGGSGGGGGGGGGGGGGGGGGGGGGGGGGGGGGGGGSGVVGGGGGGGGGGGGGGGGGG(WWWW;GGGGGGGGGGGGGGGGGS#GGGGGGOVVGGGGGGGGG@GGGGGGGGGGGGGGGGGGGTTGGGTGGGGTTTGTTTB
BGGGGGGGGGGGGGGGGGGGGGGGGGGGGGGGGGGGGGGVVGGGGGGGGGGGGGGGGGGG(WWWW;GGGGGGGGGGGG@GGGGGGGGGGGGVVGGGGGGGGGGGGGGGGGGGGGGGGGGGGTGGTTTTTGGTGTTTGTTB
BGGGGGG#GGGGGGGGGGGGGGGGGGGGGGGGGGGGGG@VVGGGGGGGGGGGGGGGGGGGG(WWWW;GGGGGGGGGGGGGGGGGGGGGGGNVVnGdGGGGGGGGGGGGGGGGGGGGGGGGGGTGGTGGGGGTTGTTTGTB
BGGGGGGGGGGGGGGGGGGGGGGGGGGGGGGGGGGGGGGVVGGGGGGGGGGGGGGGGGGGGG(WWWW;GGGGGGGGGGGGGGGGGGGGGNVVVVnGGGGGGGGGGGGGGGGGGGGGGGGGGTGGGGGGGGTGGTGTTTTB
BGGGGGGGGGGGGGGGGGGGGGGGGG#GGGGGGGGGGGGVVGGGGGGGGGGGGGGGGGGGGGG(WWWW;GGGGGGGGGGGGGGGGGGGNVVoOVVnGGGGGGGGGGGGGGGGGGGGGGGGGGGTGGTGGTGGGTGGTGGB
BGGGGGGGGGGGGGGGGGGGGGGGGGGGGGGGGGGGGGGVVGGGGGGGGGGGGGGGGGGGGGGG(WWWW;GGGGGGGGGGGGSGGGGNVVoGGOVVnGGGGGGGGGGGGGGGGGGGGGGGGGGGTGGTTGGGTGGTGGTB
BGGGGGGGGGGGGGGGGGGGGGGGGGGGGGGGGGGGGGGVVGGGGGGGGGGGGGGGGGGGGGGGG(WWWW;GGGGGGGG@GGGGGGNVVoGGGGOVVnGGGGGGGGGGGGGGGGGGGGGGGGTGGTGTGGGGGGTGGTGB
BGGGGGGGGGGGGGGGGGGGGGGGGGGGGGGGGGGGGGGVVGGGGGGGGGGGGGGGGGGGGGGGGGLWWWW;GGGGGGGGGGGGGNVVoGGGGGGOVVnSGGGGGGGGGGGGGGGGGGGGGGGGGGTGGGGGTGTGTGGB
BGGGGGGGGGGGGGGGGGGGGGGGGGGGGGGGGGGGGGGVVGGGGGGGGGGGGGGGGGGGGGGGG/WWWWWW;GGGGGGGGGGGNVVoGGGGGGGGOVVnGGGGGGGGGGGGGGSGGGGGGGGGGGGTGGGGGTGGTGTB
BGGGGGGGGGGGGGGGGGGGGGGGGGGGGGGGGGGGGGGVVGGGGGGGGGGGGGGGGGGGGGGG/WWWWWWWW;GGGGGGGGGNVVo@GGGGGGGG@OVVnGGGGGGGGGGGGGGGGGGGGGGGGGGGGGGGTGTGTGGB
BGGGGGGGGGGGGGGGGGGGGGGGGGGGGGGGGGGGGGGVVGGGGGGGGGGGGGGGGGGGGGG/WWWWWWWWWW;#GGGNVVVVVVVVVVVVVVVVVVVVVVVVVVVVVVVVVVVVVVVVVVVVVnGTGGGTGGGTGTGB
BGGGGGGGGGGGGGGGGGGGGGGGGGGGGGGGGGGGGGGVVGGGGGGGGGGGGGGGGGGGGG/WWWW)GG======VVVVVVVVVVVVVVVVVVVVVVVVVVVVVVVVVVVVVVVVVVVVVVVVVVGGTGTGTTTGTTTB
BGGGGGGGGGGGGGGGGGGGGG@GGGGGGGGGGGG@GGGVVGGGGGGGGGGGGGGGGGG@G/WWWW)GGGG======VVVV#GGGGGGGGGGGGGGGGVVGGGGGGGGGGGGGGGGGGGGGGGGVVGGGGGGGGGGGGGB
BGGGGGGGGGGGGGGGGGGGGGGGGGGGGGGGGGGGGGGVVGGGGGGGGGGGGGGGGGG#/WWWW)GGGGGG(WWWWyUUUUUUUUUUUUUUUUUUUU++UUUUUUUUUUUUUUUUUUUUUUUU++UUUUUUUUUUUUUB
BGGGGGGGGGGGGGGGGGGGGGGGGGGGGGGGGGGGGGGVVVVVVVVVVVVVVVVVVVV======GGGGGGGG(WWWWWWWWWWWWWWWWWWWWWWWW++WWWWWWWWWWWWWWWWWWWWWWWW++WWWWWWWWWWWWWB
BGGGGGGGGGGGGGGGGGGGGGGGGGGGGGGGGGGGGGGVVVVVVVVVVVVVVVVVVV======GGGGGpGGGG(WWWWWWWWWWWWWWWWWWWWWWW++WWWWWWWWWWWWWWWWWWWWWWWW++WWWWWWWWWWWWWB
BGGGGGGGGGGGGGGGGGGGGGGG#GGGGGGGGGGGGGGVVGGGGGGGGGGGGGGGGG@(WWWW;GGGGGGGGGGLWWWWWWWWWWWWWWWWWWWWWW++WWWWWWWWWWWWWWWWWWWWWWWW++WWWWWWWWWWWWWB
BGGGGGGGGGGGGGGGGGGGGGGGGGGGGGGGGGGGGGGVVGGGGGGGGGGGGGGG#GGG(WWWW;GGGGGGGGGLWWWWWWWWWWWWWWWWWWWWWW++WWWWWWWWWWWWWWWWWWWWWWWW++WWWWWWWWWWWWWB
BGGGGGGGGGG@GGGGGGGGGGGGGGGGGGGGGGGGGGGVVGGGGGGGGGGGGGGGGGGGG(WWWW;GGGGGGG/WWWWWWWWWWWWWWWWWWWWWWW++WWWWWWWWWWWWWWWWWWWWWWWW++WWWWWWWWWWWWWB
BGGGGGGGGGGGGGGGGGGGGGGGGGGGGGGGGGSGGGGVVGGGGGGGGGGGGGGGGGGGGG(WWWW;GGGGG/WWWWzuuuuuuuuuuuuuuuuuuu++uuuuuuuuuuuuuuuuuuuuuuuu++uuuuuuZWWWWWWB
BGGSGGGGGGGGGGGGGGGGGGGGGGGGGGGGGGG@GGGVVGGGGGGGGGGGGGGGGGGGGGG(WWWW;GGG======VnGGGGGGGGGGGGGGGGGGVVGGGGGGGGGGGGGGGGGGGGGGGGVVGGGGGGLWWWWWWB
BGGGGGGGGGGGGGGGGGNVVVVVVVVVVVVVVVVVVVVVVGGGGGdGGGGGGGGGGGGGGGGG(WWWW;G======VVVnGGGGGGGGGGGGGGGGGVVGGGGGGGGGGGGGGGGGGGGGGGGVVGGGGGGGZuuuuuB
BGGGGGGGGGGGGGGGGGVVVVVVVVVVVVVVVVVVVVVVoGGGGGGGGGGGGGGGG#GGGGGGG(WWWWWWWWWW)OVVVnGGGGGGGGGG@GGGGGVVGGGGGGGGGGGGGGGGGGGGGGGGVVGGGGGGQQQQQQQB
BGGGGGGGGGGGGGGGGGVVGGGGGGGGGGGGGGGGGGGGGGGGGGGGGGGGGGGGGGGGGGGGGG(WWWWWWWW)GGOVVVnGGGGGGGGGGGGGGGVVGGGGGGGGGGGGSGGGGGGGGGGGVVGGGGGGQDDDDDDB
BGGGGGGGGGGG@GGGGGVVGG#GGGGGGGGGGGGGGGGGGGGGGGGGGGGGGGGGGGGGGGGGGGG(WWWWWW)GGGGOVVVnGGGGGGGGGGGGGGVVGGGGGGGGGGGGGGGGGGGGGGGGVVGGGGGGQDDDDDDB
BGGGSGGGGGGGGGGGGGVVGGGGGGGGGGGGGGGGGSGGGGGGGGGGGGGGGGGGGGGGGGGGGGGGLWWWW)GGGGGGOVVVnGGG@GGGGGSGGGVVGGGGGGGG@GGGGGGGGGGGGGGGVVGGGGGGQDDDDDDB
BGGGGGGGGGGGGGGNVVVVGGGGGGGGGGGGGGGGGGGG@GGGGGGGGGGGGGGGGG@GGGGGGGG/WWWW)GGGGGGGGOVVVnGGGGGGGGGGGGVVGGGGGGGGGGGGGGGGGGGGGGGGVVGGGGGGQDDDDDDB
BGGGGGGGGGGGGGGVVVVoGGG#GGGGGGGGGGGGGGGGGGGGGGGGGGGGGGGGGGGGGGGGGG/WWWW)GGGGGGGGGGOVVVnGGGGGGGGGGGVVGGGGGGGGGGGGGG@@#GGGGGGGVVGGGGGGQDDDDDDB
BGGGGGGGGGGGGGGVVGGGGGGGGGGGGGGGGGGGGGGGGGGGGGGGGGGGGGGGGGGGGGGGG/WWWW)GGGGGGGGGGGGOVVVnGGGGG@GGGGVVGGGGGGGGGGGGGGGd@GGGGGGGVVGGGGGGQDDDDDDB
BUUUUUUUUUUUUUU++UUUUUUUUUUUUUUUUUUUUUUUUUUUUUUUUUU++UUUUUUUUUUUYWWWWzGGGGGGGGGGGGSGOVVVnGGGGGGGGGVVGGGGGGGGGGGGGGGGGGGGGGGGVVGGGGGGQDDDDDDB
BWWWWWWWWWWWWWW++WWWWWWWWWWWWWWWWWWWWWWWWWWWWWWWWWW++WWWWWWWWWWWWWWWWlGGGGGGGGGGGGGGGOVVVnGGGGGGGGVVGGGGGGGGGGGGGGGGGGGGGGGNVVGGGGGGQDDDDDDB
BWWWWWWWWWWWWWW++WWWWWWWWWWWWWWWWWWWWWWWWWWWWWWWWWW++WWWWWWWWWWWWWWWW)GGGGGGGGGGGG#GGGVVVVVVVVVVVVVVGGGGGGGGGGGGSGGGGGGGGGNVVoGGGGGGQDDDDDDB
BWWWWWWWWWWWWWW++WWWWWWWWWWWWWWWWWWWWWWWWWWWWWWWWWW++WWWWWWWWWWWWWWW)GGGGGGGGGGGGGGGGNVVVVVVVVVVVVVVGGGGGGGGGGGGGGGGGGGGGNVVoGGGGGGGQDDDDDDB
BWWWWWWWWWWWWWW++WWWWWWWWWWWWWWWWWWWWWWWWWWWWWWWWWW++WWWWWWWWWWWWWW)GGGGGGGGGGGGGGGGNVVVoGSGGG@GGVV##GGGGG@GGGGGGGGGGGGGNVVoGGGGGGGGQDDDDDDB
Buuuuuuuuuuuuuu++uuuuuuuuuuuuuuuuuuuuuuuuuuuuuuuuuu++uuuuuuuuuuuuuzGGGGGGGGGGGGGGGGNVVVoGGGGGGGGGVVGGGGGGGGGGGGGGGGGGGGNVVoGGGGGGGGGQDDDDDDB
BGGGGGGGGGGGGGGVVGGGGGGGGGGGGGGGGGGGGGGGGGGGGGGGGGGVVGGGGGGGGGGGGGGGGGGGGGGGGGGGGGNVVVoGGGGGGGGGGVVVVVVVVVVVVVVVVVVVV@VVVoGGGGGGGGGGQDDDDDDB
BGGGGGGGGGGGGGGVVGGGGGGGGGGGGGGGGGGGGGGGGGGGGGGGGGGV#GGGGGGGGGGGGGGGGGGGGGGG#GGGGNVVVoGGGGGGGGGGGOVVdVVVVVVVVVVVVVVVVVVVoGGGGGGGGGGQQDDDDDDB
BGGGGGGGGGGGGSGVVGGGG#GGGGSGGGGGGGGGGGGGGGGSNVVVVVVVVVVVVVVVVVVVVVVVVVVVVVVVVVVVVVVVoGGGGGGGGGGGGGGGGGGGGGGGGGGGGGGGGGGGGGGGGGGGGGQQDDDDDDDB
BGGGGGGGGGGGGGGVVnGGGGGGGGGGGGGGGGGGdGGGGGGNVVVVVVVVVVVVVVVVVVVVVVVVVVVVVVVVVVVVVVVoGGGGGGGGGGGGGGGGGGGGGGGGGGGGGGGGGGGGSGGGGGGGGQQDDDDDDDDB
BGGGGSGGGGGGGGGOVVGGGGGGGGGGGGGGGGGGGGGGGNVVVoGGGGGGGGGGGGGGGGGGGGGGGGGGGGGGGGGGGGGGGGGGGGGGGGGGGGGGGGGGGGGGGGGGGGGGGGGGGGGGGGGGQQDDDDDDDDDB
BGGGGGGGGGGGGGGGVVGGGGGGGGGGGGGGGGGGGGGGNVVoGGGGGGGGGGGGGG#GGGGG#GGGGGG#GGGGGGGGGGGGGGGGGGGGGGGGGGGGGGGGGGGGGGGGGGGGGGGGGGGGGGGQQDDDDDDDDDDB
BGGGGGGGGGGGGG#GVVVVVV@VVVVVVVVVVVVVVVVVVVoGGGGGGGG#GGGGGGGGGGGGGGGGGGGGGGGGGGGGGGGGGGGGGGGGGGGGGGGGGGGGGGGGGGGGGGGGGG@GGGGGGGGQDDDDDDDDDDDB
BGGGGGGGGGGGGGGGOVVVVVVVVVVVVVVVVVVVVVVVVoGGGGGGGGGGGGGGGGGGGGGGGGGGGGGGGGGGGGGGGGGGGGGGGGGGGGGGGGGGGGGGGGGGGGGGGGGGGGGGGGGGGGGQDDDDDDDDDDDB
BGGGGGGGGGGGGGGGGGGGGGGGGGGGGGGGGGGGGGGGGGGGGGGGGGGGGGGGGGGGGGGGGGGGGGGGGGGGGGGGGGGGGGGGGGGGGGGGGGGGGGGGGGGGGG@GG@GGGGGGGGGGGGGQDDDDDDD$DDDB
BGGGGGGGGGGGGGGGGGGGGGGGGGGGGGGGGGSGGGGGGGGGGGGGGGGGGGQQQQQQQQQQQQQQQQQQQQQQQQQQQQQQQQQQQQQQQQQQQQQQQQQQQQQQQQQ{}QQQQQQQQQQQQQQQDDDDDDDDDDDB
BGGSGGGGGGGGGGGGGGGGGGGGGGGGGGGGGGGGGGGGGGGGGGGGGGGGQQDDDDDDDDDDDDDDDDDDDDDDDDDDDDDDDDDDDDDDDDDD$DDDDD$DDDDDDDDDDDDDDD$DDDDDDDDDDD$DDDDDDDDB
BGGGGGGGGGGGGGGGGGGGGGGGGGGGGGGGGGGGGGGGGGGGGGGGGGGQQDDDDDDDDDDDDDDDDDDDDDDDDDDDDDDDDDDDDDDDDDDDDDDDDDDD$DDDDDDDDDDDDDDDDDDDDDDDDDDDDDDDDDDB
BGGGGGGGGGGGGGGGGGGGGGGGGGGGGGGGGGGGGGGGGGGGGGGGGGQQDDDDDDDDDDDDDDDDDDDDDDDDDDDDDDDDDDDDDDDDD$DDDDDD$DDDDDDDDDDDDDDDDD$DDDDDDDDDDDDDDDDDDDDB
BBBBBBBBBBBBBBBBBBBBBBBBBBBBBBBBBBBBBBBBBBBBBBBBBBBBBBBBBBBBBBBBBBBBBBBBBBBBBBBBBBBBBBBBBBBBBBBBBBBBBBBBBBBBBBBBBBBBBBBBBBBBBBBBBBBBBBBBBBBB