BCCCCCCCCCCCCCCCCCCCCCCCCCCCCCCCCCCCCCCCCCCC|WWWWWWWWWWWWWWWWWWWWWWWWWWWWWWWWWWWWWWWWWWWWWWWWWWWWWWWWWWWW)GTGGGGGGGGGGGGTGGGGGGGGGGGGGGGGGGB
BCCCCCCCCCCCCCCCCCCCCCCCCCCCCCCCCCCCCCCCCCCC|WWWWWWWWWWWWWWWWWWWWWWWWWWWWWWWWWWWWWWWWWWWWWWWWWWWWWWWWWWW)GGGTGGGGGGTGGGTGGTGGGGGTGGTGTTTTGGB
B-------|CCCCCCCCCCCCCCCCCCCCCCCCCCCCCCCCCCC|WWWWWWWWWWWWWWWWWWWWWWWWWWWWWWWWWWWWWWWWWWWWWWWWWWWWWWWWWW)GTGGGTGGGGTGGTGGGTGTGGGTGGGGTGGTTTGB
BWWWWWWW|CCCCCCCCCCCCCCCCCCCCCCCCCCCCCCCCCCC|WWWWWWWWWWWWWWWWWWWWWWWWWWWWWWWWWWWWWWWWWWWWWWWWWWWWWWWWW)GGGGGGGGGGGTGTGGGGGGGTGGGGGGGGTGTGGGB
BWWWWWWW|CCCCCCCCCCCCCCCCCCCCCCCCC|----------WWWWWWWWWWWWWWWWWWWWWWWWWWWWWWWWWWWWWWWWWWWWWWWWWWWWWWWW)GTGGGTGTGTGTTGGGGGTTGGGGTTGGGGGGGGGTTB
BWWWWWWW|CCCCCCCCCCCCCCCCCCCCCCCCC|WWWWWWWWWWWWWWWWWWWWWWWWWWWWWWWWWWWWWWWWWWWWWWWWWWWWWWWWWWWWWWWWW)GGGGGGGGGGGTGGGGTGGTGGGTGTTGTTTTTTGGTTB
BWWWWWWW|CCCCCCCCCCCCCCCCCCCCCCCCC|WWWWWWWWWWWWWWWWWWWWWWWWWWWWWWWWWWWWWWWWWWWWWWWWWWWWWWWWWWWWWWWW)GGTTGTGTTGGGGTGGGGGGGTGGGGGGGGGGGGGTTTWB
BWWWWWWW-----------|CCCCCCCCCCCCCC|WWWWWWWWWWWWWWWWWWWWWWWWWWWWWWWWWWWWWWWWWWWWWWWWWWWWWWWWWWWWWWW)GTTTTGGGGGGGGGTTTTGGGGGGGGGGGGTGTTGTTTTTB
BWWWWWWWWWWWWWWWWWW|CCCCCCCCCCCCCC|WWWzZ(WWWWWWWWWWWWWWWWWWWWWWWWWWWWWWWWWWWWWWWWWWWWWWWWWWWWWWWT)TGGGGGGGGGGGGGGGGGGGGGGGGGGGGGGTTGTTGTTTTB
BWWWWWWWWWWWWWWWWWW|CCCCCCCCCCCCCC|WWWlGGZuZWWWWWWWWWWWWWWWWWWWWWWWWWWWWWWWWWWWWWWWWWWWWWWWWWWWW)TGGGGTTTTTTTTTGGGTTTTGGTTTGGGGGSGTTGTTGTTTB
BWWWWWWWWWWWWWWWWWW|CCCCCCCCCCCCCC|WWWlGGGGGZuuuuuuuZWWWWzuuuuuuuuuuuuuuuuuuuuuuuuuuuuuuuuuuuuuzTGTGGGGTGGGGGGGGGGGGTGGGGTGTGGGGGTGTTGTTGTTB
BuuuuuuuuuuuuZWWWWW|CCCCCCCCCCCCCC|WWWlGGGGGGGGGGGGGLWWWWlGGGGGGGGGGGGGGGGGGGGGGGGGGGGGGGGGGGGGGGGTTTGGGGGGGTTTTTTGTTTGTTTGGTGGGGTTGTTGTTGTB
BGGGGGGGGGGGGG(WWWW------[]--------WWWlGGGGGGGGGGGGGLWWWWlGGGGGGGGGGGGGGGGGGGGGGGGGGGGGGGGGGGGGGGGGGTTGGTTTGTGTGGGTGGGTGTGGGGTGGGGTTGTTGTTTB
BGGGGGGGGGGGGGG(WWWWWWWWW++WWWWWWWWWW)GGGGGGGVVVVVVV======VVVVVVVVVVVVVVGGGGGGGGGGGGGGGGGGGdGGGGGGGGGGTGGTGGGGGTGGGGTGGTGTGGTTTGGTGTTGTTGTTB
BGGGGGGGGGGGGGGGZuuuuuuuu++uuuuuuuuuzGGGGGGGVVVVVVVV======VVVVVVVVVVVVVVV@GGGGGGGGGGGGGGGGGGGGGGGGGGGGGGTGTGTTTTTTGTGGGGTGGGGGGTGTTGTTGTTGTB
BGGGGGGGGGGGGGGGGGGGGGGGGVVGGGGGGGGGGGGGGGGGVVGGGGGGLWWWWlGGGGGGGGGGGGGVVGGGGGGGGGGGGGGGGGGGGGGGGGGGGGGGGGTGGGGGGGGGTGGTGTTGTGGGTGTGGTTGTTTB
BGGGGGGGGGGGGGGGGGGG#GGGGVVGGGG#GGGGGGGGGGGGVVGGGGGGLWWWWlGGGGGGGGGGGGGVVGGGGGGGGGGGGGGGGGGGGGGGGGGGGGGGGGGGTGGGGGTTTTTTTTTTTGGGTTTGTGTTGTTB
BGGGGGGGGGGGGGGGSGGGGGGGGVVGGGGGGGGGGGGGGGGGVVGGGGGGLWWWWlGGGGGGGGGGGGGVVG#GGGGGGGGGGGGGGGGGG@GGGGGGGGGGGGGGGGTGGGGGTGGGGGGGGGGGGGTGTGGTTGTB
BGGGGGGGGGGGGGGGGGGGGGGGGVVGGGGGGGGGGGGGGGGGVVGGGGGGLWWWWlGGGGGGGGGGGGGVVGGGGGGGGGGGGGGGGGGGGGGGGGGGGGGGGGGGGGGGTGGGGTGTGGTGGTGGGGTGTGTGTTTB
BGGGGGGGGGGGGGGGGGGGGGGGGVVGGGGGGGGGVVVVVVVVVVGGGGGGLWWWWlGGGGGGGGGGGGGVVGGGGGGGGGGGGGGSGGGGGGGGGGGGGGGGGGGGGGGGGGTGGGGGGGGGTGGGGGTGTGGTGTTB
BGGGGGGGGGGGGGGGGGGGGGGGGVVGGGGGGGGVVVVVVVVVVGGGGGGGLWWWWlGGGGGGGGGGGGGVVGGGGGGGGGGGGGGGGGGGGGGGGGGGGGGGGGGGGGGGGG|GGGGTGTGGGGGGGTGTGTGTGGTB
BGGGGGGGGGGGGGGGGGGGGGGGGVVVVVVVVVVVVGGGGGSGGGGGGGGGLWWWWlGGGGGGGGGGGGGVVGGGGGGGGG#GGGGGGGGGGGGGGGGGGGGGGGGGGGGGGG|GGGTGTGTTTTTTTTTTGTTTTTGB
BGGGGGGGGGGGGGGGGGGGGGGGGVVVVVVVVVVGGGGGGGGGGGGGGGGGLWWWWlGGGGGGGGGGGGGVVGG@GGGGGGGGGGGGGGGGGGGGGGGGGGGGGGG@GGGGGG--<>--TGGGGGGGGGTTTGTTTTGB
BGGGGGGGGGGGGGGGGGGGGGGGGG@GGGGGVVGGGGG@GGGGGGGGGGGGLWWWWlGGGGGGGGGGGGGVVVVVVVVVVVVVVVVVVVVGGGGGGGGGGGGGGGGGGGGGGGGGGGGGTTGGGGGGTTGTTTGTTGTB
BGGGG@GGGGGGGdGGGGGGGGGGGGGGGGGGVVGGGGGGGGGGGGGGGGGGLWWWWlGGGGGGGGGGGGGVVVVVVVVVVV@VVVVVVVVVGGGGGGGGGGGGGGGGGGGGGGGGGGGGGGTGGGTTGTTGTTTGTTTB
BGGGGGGGGGGGGGGGGGGGGGGGGGGGGGGGVVGGGGGGGGGGGGGGGGGGLWWWWlGGGGGGGGGGGGGVVGGGGGGGGGGGGGGGGGVVGGGGGGGGGGGGGGGGGGGGGGGGGGGGTTGTGGTGGGGTGTGTTTTB
BGGGGGGGGGGGGGGGGGGGGGGGGGGGGGGGVVG#GGGGGGGGGGGGGGGGLWWWWlGGGGGGGGGGGGGVVGGGGGGGGGGGGGGGGGVVGGGGGGGGGGGGGGGGGGG@GGGGGGGGGTGGTTGTGGGGTGTGTTTB
BGGGGGGGGGGGGGGGGGGGGGGGGGGGGGGGVVGGGGGGGGGGGGGGGGGGLWWWWlGGGGGGGGGGGGGVVGGGGGdGGGGGGGGGGGVVGGGGGGGGGGGGGGGGGGGGGGGGGGGGTGTTTGGGGGGGGTTTGTTB
BGGGGGGGGGGGGGGGGGGGGGGGGGGGGGGGVVSGGGGGGGGGGGGGGGGGG(WWWW;GGGGGGGGGGGGVVGGGGGGGGGGGGGGGGGVVGGGGGGGSGGGGGGGGGGGGGGGGGGSGGTGGGTGGTGGGTGTTTGTB
BGGSGGGGGGGGGGGGGGGGGGGGGGGGGGGGVVGGGGGGGGGGGGGGGGGGGG(WWWW;GGGGGGGGGGGVVGGGGGGGGGGGGGGGGGVVGGGGGGGGGGGGGGGGGGGGGGGGGGGGTGTTGGTGGTGGTTGTTTGB
BGGGGGGGGGG#GGGGGGGGGGGGGGGGGGGGVVGGGGGGG@GGGGGGGGGGGGG(WWWW;GGGGGVVVVVVVGGGGGGGGGGGGGGGGGVVGGGGGGGGGGGGGGGGGGGGGGGGGGGGGTGGTTGTGTTGTTTGTTTB
BGGGGGGGGGGGGGGGGGGGGGGGGGGGGGGGVVVVVVVVVVVVVVVVVVVVVVVV======VVVVVVVVVVGGGGGGGGGGG@GGGGGGVVGGGGGGGGGGGGGGGGGGGGGGGGGGGGGTGGGTGGTGGTGTTTGTTB
BGGGGGGGGGGGGGGGGGGGGGGGGGGGGGGGGVVVVVVVVVVVVVVVVVVVVVVVV======VVVVGGGGGGGGGGGGGGGGGGGGGGGVVGGGGGGGGGGGGGGGGGGGGGGGGGGGGGGGGTGTGGTTGTGTTTGTB
BGGGGGGGGGGGGGGGGGGGGGGGG#GGGGGGGGGGGGGVVGGGGGGGGGGGGGGGGG(WWWW;GGGGGGGGGGGGGGGGGGGGGGGGGGVVGGGGGGGGGGGGGGGGGGGGGGGGGGGGGTTTGGGGGTGGTTGTTTGB
BGGGSGGGGGGGGGGGGGGGGGGGGGGGGGGGGGGGGSGVVGGGGGGGGGGGGGGGGGG(WWWW;GGGGGGGGGGGGGGGGGS#GGGGGGGVVGGGGGGGGG@GGGGGGGGGGGGGGGGGGGTTGGGTGGGGTTTGTTTB
BGGGGGGGGGGGGGGGGGGGGGGGGGGGGGGGGGGGGGGVVGGGGGGGGGGGGGGGGGGG(WWWW;GGGGGGGGGGGG@GGGGGGGGGGGGVVGGGGGGGGGGGGGGGGGGGGGGGGGGGGTGGTTTTTGGTGTTTGTTB
BGGGGGG#GGGGGGGGGGGGGGGGGGGGGGGGGGGGGG@VVGGGGGGGGGGGGGGGGGGGG(WWWW;GGGGGGGGGGGGGGGGGGGGGGGGVVGGdGGGGGGGGGGGGGGGGGGGGGGGGGGTGGTGGGGGTTGTTTGTB
BGGGGGGGGGGGGGGGGGGGGGGGGGGGGGGGGGGGGGGVVGGGGGGGGGGGGGGGGGGGGG(WWWW;GGGGGGGGGGGGGGGGGGGGGGVVVVGGGGGGGGGGGGGGGGGGGGGGGGGGGTGGGGGGGGTGGTGTTTTB
BGGGGGGGGGGGGGGGGGGGGGGGGG#GGGGGGGGGGGGVVGGGGGGGGGGGGGGGGGGGGGG(WWWW;GGGGGGGGGGGGGGGGGGGGVVGGVVGGGGGGGGGGGGGGGGGGGGGGGGGGGGTGGTGGTGGGTGGTGGB
BGGGGGGGGGGGGGGGGGGGGGGGGGGGGGGGGGGGGGGVVGGGGGGGGGGGGGGGGGGGGGGG(WWWW;GGGGGGGGGGGGSGGGGGVVGGGGVVGGGGGGGGGGGGGGGGGGGGGGGGGGGGTGGTTGGGTGGTGGTB
BGGGGGGGGGGGGGGGGGGGGGGGGGGGGGGGGGGGGGGVVGGGGGGGGGGGGGGGGGGGGGGGG(WWWW;GGGGGGGG@GGGGGGGVVGGGGGGVVGGGGGGGGGGGGGGGGGGGGGGGGGTGGTGTGGGGGGTGGTGB
BGGGGGGGGGGGGGGGGGGGGGGGGGGGGGGGGGGGGGGVVGGGGGGGGGGGGGGGGGGGGGGGGGLWWWW;GGGGGGGGGGGGGGVVGGGGGGGGVVGSGGGGGGGGGGGGGGGGGGGGGGGGGGTGGGGGTGTGTGGB
BGGGGGGGGGGGGGGGGGGGGGGGGGGGGGGGGGGGGGGVVGGGGGGGGGGGGGGGGGGGGGGGG/WWWWWW;GGGGGGGGGGGGVVGGGGGGGGGGVVGGGGGGGGGGGGGGGSGGGGGGGGGGGGTGGGGGTGGTGTB
BGGGGGGGGGGGGGGGGGGGGGGGGGGGGGGGGGGGGGGVVGGGGGGGGGGGGGGGGGGGGGGG/WWWWWWWW;GGGGGGGGGGVVG@GGGGGGGG@GVVGGGGGGGGGGGGGGGGGGGGGGGGGGGGGGGGTGTGTGGB
BGGGGGGGGGGGGGGGGGGGGGGGGGGGGGGGGGGGGGGVVGGGGGGGGGGGGGGGGGGGGGG/WWWWWWWWWW;#GGGGVVVVVVVVVVVVVVVVVVVVVVVVVVVVVVVVVVVVVVVVVVVVVGGTGGGTGGGTGTGB
BGGGGGGGGGGGGGGGGGGGGGGGGGGGGGGGGGGGGGGVVGGGGGGGGGGGGGGGGGGGGG/WWWW)GG======VVVVVVVVVVVVVVVVVVVVVVVVVVVVVVVVVVVVVVVVVVVVVVVVVVGGTGTGTTTGTTTB
BGGGGGGGGGGGGGGGGGGGGG@GGGGGGGGGGGG@GGGVVGGGGGGGGGGGGGGGGGG@G/WWWW)GGGG======VVVV#GGGGGGGGGGGGGGGGVVGGGGGGGGGGGGGGGGGGGGGGGGVVGGGGGGGGGGGGGB
BGGGGGGGGGGGGGGGGGGGGGGGGGGGGGGGGGGGGGGVVGGGGGGGGGGGGGGGGGG#/WWWW)GGGGGG(WWWWyUUUUUUUUUUUUUUUUUUUU++UUUUUUUUUUUUUUUUUUUUUUUU++UUUUUUUUUUUUUB
BGGGGGGGGGGGGGGGGGGGGGGGGGGGGGGGGGGGGGGVVVVVVVVVVVVVVVVVVVV======GGGGGGGG(WWWWWWWWWWWWWWWWWWWWWWWW++WWWWWWWWWWWWWWWWWWWWWWWW++WWWWWWWWWWWWWB
BGGGGGGGGGGGGGGGGGGGGGGGGGGGGGGGGGGGGGGVVVVVVVVVVVVVVVVVVV======GGGGGpGGGG(WWWWWWWWWWWWWWWWWWWWWWW++WWWWWWWWWWWWWWWWWWWWWWWW++WWWWWWWWWWWWWB
BGGGGGGGGGGGGGGGGGGGGGGG#GGGGGGGGGGGGGGVVGGGGGGGGGGGGGGGGG@(WWWW;GGGGGGGGGGLWWWWWWWWWWWWWWWWWWWWWW++WWWWWWWWWWWWWWWWWWWWWWWW++WWWWWWWWWWWWWB
BGGGGGGGGGGGGGGGGGGGGGGGGGGGGGGGGGGGGGGVVGGGGGGGGGGGGGGG#GGG(WWWW;GGGGGGGGGLWWWWWWWWWWWWWWWWWWWWWW++WWWWWWWWWWWWWWWWWWWWWWWW++WWWWWWWWWWWWWB
BGGGGGGGGGG@GGGGGGGGGGGGGGGGGGGGGGGGGGGVVGGGGGGGGGGGGGGGGGGGG(WWWW;GGGGGGG/WWWWWWWWWWWWWWWWWWWWWWW++WWWWWWWWWWWWWWWWWWWWWWWW++WWWWWWWWWWWWWB
BGGGGGGGGGGGGGGGGGGGGGGGGGGGGGGGGGSGGGGVVGGGGGGGGGGGGGGGGGGGGG(WWWW;GGGGG/WWWWzuuuuuuuuuuuuuuuuuuu++uuuuuuuuuuuuuuuuuuuuuuuu++uuuuuuZWWWWWWB
BGGSGGGGGGGGGGGGGGGGGGGGGGGGGGGGGGG@GGGVVGGGGGGGGGGGGGGGGGGGGGG(WWWW;GGG======VGGGGGGGGGGGGGGGGGGGVVGGGGGGGGGGGGGGGGGGGGGGGGVVGGGGGGLWWWWWWB
BGGGGGGGGGGGGGGGGGGVVVVVVVVVVVVVVVVVVVVVVGGGGGdGGGGGGGGGGGGGGGGG(WWWW;G======VVVGGGGGGGGGGGGGGGGGGVVGGGGGGGGGGGGGGGGGGGGGGGGVVGGGGGGGZuuuuuB
BGGGGGGGGGGGGGGGGGVVVVVVVVVVVVVVVVVVVVVVGGGGGGGGGGGGGGGGG#GGGGGGG(WWWWWWWWWW)GVVVGGGGGGGGGGG@GGGGGVVGGGGGGGGGGGGGGGGGGGGGGGGVVGGGGGGQQQQQQQB
BGGGGGGGGGGGGGGGGGVVGGGGGGGGGGGGGGGGGGGGGGGGGGGGGGGGGGGGGGGGGGGGGG(WWWWWWWW)GGGVVVGGGGGGGGGGGGGGGGVVGGGGGGGGGGGGSGGGGGGGGGGGVVGGGGGGQDDDDDDB
BGGGGGGGGGGG@GGGGGVVGG#GGGGGGGGGGGGGGGGGGGGGGGGGGGGGGGGGGGGGGGGGGGG(WWWWWW)GGGGGVVVGGGGGGGGGGGGGGGVVGGGGGGGGGGGGGGGGGGGGGGGGVVGGGGGGQDDDDDDB
BGGGSGGGGGGGGGGGGGVVGGGGGGGGGGGGGGGGGSGGGGGGGGGGGGGGGGGGGGGGGGGGGGGGLWWWW)GGGGGGGVVVGGGG@GGGGGSGGGVVGGGGGGGG@GGGGGGGGGGGGGGGVVGGGGGGQDDDDDDB
BGGGGGGGGGGGGGGVVVVVGGGGGGGGGGGGGGGGGGGG@GGGGGGGGGGGGGGGGG@GGGGGGGG/WWWW)GGGGGGGGGVVVGGGGGGGGGGGGGVVGGGGGGGGGGGGGGGGGGGGGGGGVVGGGGGGQDDDDDDB
BGGGGGGGGGGGGGGVVVVGGGG#GGGGGGGGGGGGGGGGGGGGGGGGGGGGGGGGGGGGGGGGGG/WWWW)GGGGGGGGGGGVVVGGGGGGGGGGGGVVGGGGGGGGGGGGGG@@#GGGGGGGVVGGGGGGQDDDDDDB
BGGGGGGGGGGGGGGVVGGGGGGGGGGGGGGGGGGGGGGGGGGGGGGGGGGGGGGGGGGGGGGGG/WWWW)GGGGGGGGGGGGGVVVGGGGGG@GGGGVVGGGGGGGGGGGGGGGd@GGGGGGGVVGGGGGGQDDDDDDB
BUUUUUUUUUUUUUU++UUUUUUUUUUUUUUUUUUUUUUUUUUUUUUUUUU++UUUUUUUUUUUYWWWWzGGGGGGGGGGGGSGGVVVGGGGGGGGGGVVGGGGGGGGGGGGGGGGGGGGGGGGVVGGGGGGQDDDDDDB
BWWWWWWWWWWWWWW++WWWWWWWWWWWWWWWWWWWWWWWWWWWWWWWWWW++WWWWWWWWWWWWWWWWlGGGGGGGGGGGGGGGGVVVGGGGGGGGGVVGGGGGGGGGGGGGGGGGGGGGGGVVVGGGGGGQDDDDDDB
BWWWWWWWWWWWWWW++WWWWWWWWWWWWWWWWWWWWWWWWWWWWWWWWWW++WWWWWWWWWWWWWWWW)GGGGGGGGGGGG#GGGGVVVVVVVVVVVVVGGGGGGGGGGGGSGGGGGGGGGVVVGGGGGGGQDDDDDDB
BWWWWWWWWWWWWWW++WWWWWWWWWWWWWWWWWWWWWWWWWWWWWWWWWW++WWWWWWWWWWWWWWW)GGGGGGGGGGGGGGGGGVVVVVVVVVVVVVVVGGGGGGGGGGGGGGGGGGGGVVVGGGGGGGGQDDDDDDB
BWWWWWWWWWWWWWW++WWWWWWWWWWWWWWWWWWWWWWWWWWWWWWWWWW++WWWWWWWWWWWWWW)GGGGGGGGGGGGGGGGGVVVGGSGGG@GGVV##GGGGG@GGGGGGGGGGGGGVVVGGGGGGGGGQDDDDDDB
Buuuuuuuuuuuuuu++uuuuuuuuuuuuuuuuuuuuuuuuuuuuuuuuuu++uuuuuuuuuuuuuzGGGGGGGGGGGGGGGGGVVVGGGGGGGGGGVVGGGGGGGGGGGGGGGGGGGGVVVGGGGGGGGGGQDDDDDDB
BGGGGGGGGGGGGGGVVGGGGGGGGGGGGGGGGGGGGGGGGGGGGGGGGGGGGGGGGGGGGGGGGGGGGGGGGGGGGGGGGGGVVVGGGGGGGGGGGVVVVVVVVVVVVVVVVVVVV@VVVGGGGGGGGGGGQDDDDDDB
BGGGGGGGGGGGGGGVVGGGGGGGGGGGGGGGGGGGGGGGGGGGGGGGGGGG#GGGGGGGGGGGGGGGGGGGGGGG#GGGGGVVVGGGGGGGGGGGGGVVdVVVVVVVVVVVVVVVVVVGGGGGGGGGGGGQQDDDDDDB
BGGGGGGGGGGGGSGVVGGGG#GGGGSGGGGGGGGGGGGGGGGSGVVVVVVVVVVVVVVVVVVVVVVVVVVVVVVVVVVVVVVVGGGGGGGGGGGGGGGGGGGGGGGGGGGGGGGGGGGGGGGGGGGGGGQQDDDDDDDB
BGGGGGGGGGGGGGGVVGGGGGGGGGGGGGGGGGGGdGGGGGGGVVVVVVVVVVVVVVVVVVVVVVVVVVVVVVVVVVVVVVVGGGGGGGGGGGGGGGGGGGGGGGGGGGGGGGGGGGGGSGGGGGGGGQQDDDDDDDDB
BGGGGSGGGGGGGGGVVVGGGGGGGGGGGGGGGGGGGGGGGGGVVVGGGGGGGGGGGGGGGGGGGGGGGGGGGGGGGGGGGGGGGGGGGGGGGGGGGGGGGGGGGGGGGGGGGGGGGGGGGGGGGGGGQQDDDDDDDDDB
BGGGGGGGGGGGGGGGVVGGGGGGGGGGGGGGGGGGGGGGGVVVGGGGGGGGGGGGGG#GGGGG#GGGGGG#GGGGGGGGGGGGGGGGGGGGGGGGGGGGGGGGGGGGGGGGGGGGGGGGGGGGGGGQQDDDDDDDDDDB
BGGGGGGGGGGGGG#GVVVVVV@VVVVVVVVVVVVVVVVVVVVGGGGGGGG#GGGGGGGGGGGGGGGGGGGGGGGGGGGGGGGGGGGGGGGGGGGGGGGGGGGGGGGGGGGGGGGGGG@GGGGGGGGQDDDDDDDDDDDB
BGGGGGGGGGGGGGGGVVVVVVVVVVVVVVVVVVVVVVVVVGGGGGGGGGGGGGGGGGGGGGGGGGGGGGGGGGGGGGGGGGGGGGGGGGGGGGGGGGGGGGGGGGGGGGGGGGGGGGGGGGGGGGGQDDDDDDDDDDDB
BGGGGGGGGGGGGGGGGGGGGGGGGGGGGGGGGGGGGGGGGGGGGGGGGGGGGGGGGGGGGGGGGGGGGGGGGGGGGGGGGGGGGGGGGGGGGGGGGGGGGGGGGGGGGG@GG@GGGGGGGGGGGGGQDDDDDDD$DDDB
BGGGGGGGGGGGGGGGGGGGGGGGGGGGGGGGGGSGGGGGGGGGGGGGGGGGGGQQQQQQQQQQQQQQQQQQQQQQQQQQQQQQQQQQQQQQQQQQQQQQQQQQQQQQQQQ{}QQQQQQQQQQQQQQQDDDDDDDDDDDB
BGGSGGGGGGGGGGGGGGGGGGGGGGGGGGGGGGGGGGGGGGGGGGGGGGGGQQDDDDDDDDDDDDDDDDDDDDDDDDDDDDDDDDDDDDDDDDDD$DDDDD$DDDDDDDDDDDDDDD$DDDDDDDDDDD$DDDDDDDDB
BGGGGGGGGGGGGGGGGGGGGGGGGGGGGGGGGGGGGGGGGGGGGGGGGGGQQDDDDDDDDDDDDDDDDDDDDDDDDDDDDDDDDDDDDDDDDDDDDDDDDDDD$DDDDDDDDDDDDDDDDDDDDDDDDDDDDDDDDDDB
BGGGGGGGGGGGGGGGGGGGGGGGGGGGGGGGGGGGGGGGGGGGGGGGGGQQDDDDDDDDDDDDDDDDDDDDDDDDDDDDDDDDDDDDDDDDD$DDDDDD$DDDDDDDDDDDDDDDDD$DDDDDDDDDDDDDDDDDDDDB
BBBBBBBBBBBBBBBBBBBBBBBBBBBBBBBBBBBBBBBBBBBBBBBBBBBBBBBBBBBBBBBBBBBBBBBBBBBBBBBBBBBBBBBBBBBBBBBBBBBBBBBBBBBBBBBBBBBBBBBBBBBBBBBBBBBBBBBBBBBB