BCCCCCCCCCCCCCCCCCCCCCCCCCCCCCCCCCCCCCCCCCCCCCCCCCCCC|WWWWWWWWWWWWWWWWWWWWWWWWWWWWWWWWWWWWWWWWWWWWWWWWWWWWWWWWWWWW)GTGGGGGGGGGGGGTGGGGGGGGGGGGGGGGGGB
BCCCCCCCCCCCCCCCCCCCCCCCCCCCCCCCCCCCCCCCCCCCCCCCCCCCC|WWWWWWWWWWWWWWWWWWWWWWWWWWWWWWWWWWWWWWWWWWWWWWWWWWWWWWWWWWW)GGGTGGGGGGTGGGTGGTGGGGGTGGTGTTTTGGB
B----------------|CCCCCCCCCCCCCCCCCCCCCCCCCCCCCCCCCCC|WWWWWWWWWWWWWWWWWWWWWWWWWWWWWWWWWWWWWWWWWWWWWWWWWWWWWWWWWW)GTGGGTGGGGTGGTGGGTGTGGGTGGGGTGGTTTGB
BWWWWWWWWWWWWWWWW|CCCCCCCCCCCCCCCCCCCCCCCCCCCCCCCCCCC|WWWWWWWWWWWWWWWWWWWWWWWWWWWWWWWWWWWWWWWWWWWWWWWWWWWWWWWWW)GGGGGGGGGGGTGTGGGGGGGTGGGGGGGGTGTGGGB
BWWWWWWWWWWWWWWWW|CCCCCCCCCCCCCCCCCCCCCCCCC|----------WWWWWWWWWWWWWWWWWWWWWWWWWWWWWWWWWWWWWWWWWWWWWWWWWWWWWWWW)GTGGGTGTGTGTTGGGGGTTGGGGTTGGGGGGGGGTTB
BWWWWWWWWWWWWWWWW|CCCCCCCCCCCCCCCCCCCCCCCCC|WWWWWWWWWWWWWWWWWWWWWWWWWWWWWWWWWWWWWWWWWWWWWWWWWWWWWWWWWWWWWWWWW)GGGGGGGGGGGTGGGGTGGTGGGTGTTGTTTTTTGGTTB
BWWWWWWWWWWWWWWWW|CCCCCCCCCCCCCCCCCCCCCCCCC|WWWWWWWWWWWWWWWWWWWWWWWWWWWWWWWWWWWWWWWWWWWWWWWWWWWWWWWWWWWWWWWW)GGTTGTGTTGGGGTGGGGGGGTGGGGGGGGGGGGGTTTWB
BWWWWWWWWWWWWWWWW-----------|CCCCCCCCCCCCCC|WWWWWWWWWWWWWWWWWWWWWWWWWWWWWWWWWWWWWWWWWWWWWWWWWWWWWWWWWWWWWWW)GTTTTGGGGGGGGGTTTTGGGGGGGGGGGGTGTTGTTTTTB
BWWWWWWWWWWWWWWWWWWWWWWWWWWW|CCCCCCCCCCCCCC|WWWzZ(WWWWWWWWWWWWWWWWWWWWWWWWWWWWWWWWWWWWWWWWWWWWWWWWWWWWWWWT)TGGGGGGGGGGGGGGGGGGGGGGGGGGGGGGTTGTTGTTTTB
BWWWWWWWWWWWWWWWWWWWWWWWWWWW|CCCCCCCCCCCCCC|WWWlGGZuZWWWWWWWWWWWWWWWWWWWWWWWWWWWWWWWWWWWWWWWWWWWWWWWWWWWW)TGGGGTTTTTTTTTGGGTTTTGGTTTGGGGGSGTTGTTGTTTB
BWWWWWWWWWWWWWWWWWWWWWWWWWWW|CCCCCCCCCCCCCC|WWWlGGGGGZuuuuuuuZWWWWzuuuuuuuuuuuuuuuuuuuuuuuuuuuuuuuuuuuuuzTGTGGGGTGGGGGGGGGGGGTGGGGTGTGGGGGTGTTGTTGTTB
BuuuuuuuuuuuuuuuuuuuuuZWWWWW|CCCCCCCCCCCCCC|WWWlGGGGGGGGGGGGGLWWWWlGGGGGGGGGGGGGGGGGGGGGGGGGGGGGGGGGGGGGGGGTTTGGGGGGGTTTTTTGTTTGTTTGGTGGGGTTGTTGTTGTB
BGGGGGTGGTGGGGGGGGGGGGG(WWWW------[]--------WWWlGGGGGGGGGGGGGLWWWWlGGGGGGGGGGGGGGGGGGGGGGGGGGGGGGGGGGGGGGGGGGTTGGTTTGTGTGGGTGGGTGTGGGGTGGGGTTGTTGTTTB
BGTGGTGGGGGGGGGGGGGGGGGG(WWWWWWWWW++WWWWWWWWWW)GGGGGGNVVVVVVV======VVVVVVVVVVVVVVnGGGGGGGGGGGGGGGGGGdGGGGGGGGGGTGGTGGGGGTGGGGTGGTGTGGTTTGGTGTTGTTGTTB
BGGGGGTGGGGGGGGGGGGGGGGGGZuuuuuuuu++uuuuuuuuuzGGGGGGGVVVVVVVV======VVVVVVVVVVVVVVV@GGGGGGGGGGGGGGGGGGGGGGGGGGGGGGTGTGTTTTTTGTGGGGTGGGGGGTGTTGTTGTTGTB
BGTGGGGTGTGGGGGGGGGGGGGGGGGGGGGGGGVVGGGGGGGGGGGGGGGGGVVGGGGGGLWWWWlGGGGGGGGGGGGGVVGGGGGGGGGGGGGGGGGGGGGGGGGGGGGGGGGTGGGGGGGGGTGGTGTTGTGGGTGTGGTTGTTTB
BGGGGGTGGGGGGGGGGGGGGGGGGGGGG#GGGGVVGGGG#GGGGGGGGGGGGVVGGGGGGLWWWWlGGGGGGGGGGGGGVVGGGGGGGGGGGGGGGGGGGGGGGGGGGGGGGGGGGTGGGGGTTTTTTTTTTTGGGTTTGTGTTGTTB
BGGGGGGTTGGGGGGGGGGGGGGGGSGGGGGGGGVVGGGGGGGGGGGGGGGGGVVGGGGGGLWWWWlGGGGGGGGGGGGGVVG#GGGGGGGGGGGGGGGGGG@GGGGGGGGGGGGGGGGTGGGGGTGGGGGGGGGGGGGTGTGGTTGTB
BGGTTTGGGGGGGGGGGGGGGGGGGGGGGGGGGGVVGGGGGGGGGGGGGGGGGVVGGGGGGLWWWWlGGGGGGGGGGGGGVVGGGGGGGGGGGGGGGGGGGGGGGGGGGGGGGGGGGGGGGTGGGGTGTGGTGGTGGGGTGTGTGTTTB
BGGGGGTGGGGGGGGGGGGGGGGGGGGGGGGGGGVVGGGGGGGGGNVVVVVVVVoGGGGGGLWWWWlGGGGGGGGGGGGGVVGGGGGGGGGGGGGGSGGGGGGGGGGGGGGGGGGGGGGGGGGTGGGGGGGGGTGGGGGTGTGGTGTTB
BGGGGTGGGTGGGGGGGGGGGGGGGGGGGGGGGGVVGGGGGGGGNVVVVVVVVoGGGGGGGLWWWWlGGGGGGGGGGGGGVVGGGGGGGGGGGGGGGGGGGGGGGGGGGGGGGGGGGGGGGGG|GGGGTGTGGGGGGGTGTGTGTGGTB
BGGGGGGTGGGGGGGGGGGGGGGGGGGGGGGGGGVVVVVVVVVVVoGGGGGSGGGGGGGGGLWWWWlGGGGGGGGGGGGGVVGGGGGGGGG#GGGGGGGGGGGGGGGGGGGGGGGGGGGGGGG|GGGTGTGTTTTTTTTTTGTTTTTGB
BGGGGGTTGGGGGGGGGGGGGGGGGGGGGGGGGGOVVVVVVVVoGGGGGGGGGGGGGGGGGLWWWWlGGGGGGGGGGGGGVVGG@GGGGGGGGGGGGGGGGGGGGGGGGGGGGGGG@GGGGGG--<>--TGGGGGGGGGTTTGTTTTGB
BGGGTGGGGTGGGGGGGGGGGGGGGGGGGGGGGGG@GGGGGVVGGGGG@GGGGGGGGGGGGLWWWWlGGGGGGGGGGGGGVVVVVVVVVVVVVVVVVVVVnGGGGGGGGGGGGGGGGGGGGGGGGGGGGTTGGGGGGTTGTTTGTTGTB
BGGGGTGGGGGGGG@GGGGGGGdGGGGGGGGGGGGGGGGGGVVGGGGGGGGGGGGGGGGGGLWWWWlGGGGGGGGGGGGGVVVVVVVVVVV@VVVVVVVVVGGGGGGGGGGGGGGGGGGGGGGGGGGGGGGTGGGTTGTTGTTTGTTTB
BGGGGGTGGGGGGGGGGGGGGGGGGGGGGGGGGGGGGGGGGVVGGGGGGGGGGGGGGGGGGLWWWWlGGGGGGGGGGGGGVVGGGGGGGGGGGGGGGGGVVGGGGGGGGGGGGGGGGGGGGGGGGGGGGTTGTGGTGGGGTGTGTTTTB
BGGGGGGGGTGGGGGGGGGGGGGGGGGGGGGGGGGGGGGGGVVG#GGGGGGGGGGGGGGGGLWWWWlGGGGGGGGGGGGGVVGGGGGGGGGGGGGGGGGVVGGGGGGGGGGGGGGGGGGG@GGGGGGGGGTGGTTGTGGGGTGTGTTTB
BGGGGGTGGGGGGGGGGGGGGGGGGGGGGGGGGGGGGGGGGVVGGGGGGGGGGGGGGGGGGLWWWWlGGGGGGGGGGGGGVVGGGGGdGGGGGGGGGGGVVGGGGGGGGGGGGGGGGGGGGGGGGGGGGTGTTTGGGGGGGGTTTGTTB
BGGGTGGGGTGGGGGGGGGGGGGGGGGGGGGGGGGGGGGGGVVSGGGGGGGGGGGGGGGGGG(WWWW;GGGGGGGGGGGGVVGGGGGGGGGGGGGGGGGVVGGGGGGGSGGGGGGGGGGGGGGGGGGSGGTGGGTGGTGGGTGTTTGTB
BGGTGTGGGGGGGGGGGGGGGGGGGGGGGGGGGGGGGGGGGVVGGGGGGGGGGGGGGGGGGGG(WWWW;GGGGGGGGGGGVVGGGGGGGGGGGGGGGGGVVGGGGGGGGGGGGGGGGGGGGGGGGGGGGTGTTGGTGGTGGTTGTTTGB
BGGGGGTGTGTGGGGGGGGG#GGGGGGGGGGGGGGGGGGGGVVGGGGGGG@GGGGGGGGGGGGG(WWWW;GGGGNVVVVVVVGGGGGGGGGGGGGGGGGVVGGGGGGGGGGGGGGGGGGGGGGGGGGGGGTGGTTGTGTTGTTTGTTTB
BGGGGGGGGGGGGGGGGGGGGGGGGGGGGGGGGGGGGGGGGVVVVVVVVVVVVVVVVVVVVVVVV======VVVVVVVVVVGGGGGGGGGGG@GGGGGGVVGGGGGGGGGGGGGGGGGGGGGGGGGGGGGTGGGTGGTGGTGTTTGTTB
BGGGTGGTGGTGGGGGGGGGGGGGGGGGGGGGGGGGGGGGGOVVVVVVVVVVVVVVVVVVVVVVVV======VVVVoGGGGGGGGGGGGGGGGGGGGGGVVGGGGGGGGGGGGGGGGGGGGGGGGGGGGGGGGTGTGGTTGTGTTTGTB
BGTGGTGGGGGGGGGGGGGGGGGGGGGGGGGGGG#GGGGGGGGGGGGGVVGGGGGGGGGGGGGGGGG(WWWW;GGGGGGGGGGGGGGGGGGGGGGGGGGVVnGGGGGGGGGGGGGGGGGGGGGGGGGGGGTTTGGGGGTGGTTGTTTGB
BGGGGGGGGGGGGSGGGGGGGGGGGGGGGGGGGGGGGGGGGGGGGGSGVVGGGGGGGGGGGGGGGGGG(WWWW;GGGGGGGGGGGGGGGGGS#GGGGGGOVVGGGGGGGGG@GGGGGGGGGGGGGGGGGGGTTGGGTGGGGTTTGTTTB
BGGTGTGGGGTGGGGGGGGGGGGGGGGGGGGGGGGGGGGGGGGGGGGGVVGGGGGGGGGGGGGGGGGGG(WWWW;GGGGGGGGGGGG@GGGGGGGGGGGGVVGGGGGGGGGGGGGGGGGGGGGGGGGGGGTGGTTTTTGGTGTTTGTTB
BGTGGTGGGGGGGGGG#GGGGGGGGGGGGGGGGGGGGGGGGGGGGGG@VVGGGGGGGGGGGGGGGGGGGG(WWWW;GGGGGGGGGGGGGGGGGGGGGGGNVVnGdGGGGGGGGGGGGGGGGGGGGGGGGGGTGGTGGGGGTTGTTTGTB
BGGGTGGGGGGGGGGGGGGGGGGGGGGGGGGGGGGGGGGGGGGGGGGGVVGGGGGGGGGGGGGGGGGGGGG(WWWW;GGGGGGGGGGGGGGGGGGGGGNVVVVnGGGGGGGGGGGGGGGGGGGGGGGGGGTGGGGGGGGTGGTGTTTTB
BGGGGTGGGGGTGGGGGGGGGGGGGGGGGGGGGGG#GGGGGGGGGGGGVVGGGGGGGGGGGGGGGGGGGGGG(WWWW;GGGGGGGGGGGGGGGGGGGNVVoOVVnGGGGGGGGGGGGGGGGGGGGGGGGGGGTGGTGGTGGGTGGTGGB
BGGTGGTGTGGGGGGGGGGGGGGGGGGGGGGGGGGGGGGGGGGGGGGGVVGGGGGGGGGGGGGGGGGGGGGGG(WWWW;GGGGGGGGGGGGSGGGGNVVoGGOVVnGGGGGGGGGGGGGGGGGGGGGGGGGGGTGGTTGGGTGGTGGTB
BGGGGGGGGGTGGGGGGGGGGGGGGGGGGGGGGGGGGGGGGGGGGGGGVVGGGGGGGGGGGGGGGGGGGGGGGG(WWWW;GGGGGGGG@GGGGGGNVVoGGGGOVVnGGGGGGGGGGGGGGGGGGGGGGGGTGGTGTGGGGGGTGGTGB
BGGTGGTGGGGGGGGGGGGGGGGGGGGGGGGGGGGGGGGGGGGGGGGGVVGGGGGGGGGGGGGGGGGGGGGGGGGLWWWW;GGGGGGGGGGGGGNVVoGGGGGGOVVnSGGGGGGGGGGGGGGGGGGGGGGGGGGTGGGGGTGTGTGGB
BGGGGGGGGGTGGGGGGGGGGGGGGGGGGGGGGGGGGGGGGGGGGGGGVVGGGGGGGGGGGGGGGGGGGGGGGG/WWWWWW;GGGGGGGGGGGNVVoGGGGGGGGOVVnGGGGGGGGGGGGGGSGGGGGGGGGGGGTGGGGGTGGTGTB
BGTGGGGTGGGTGGGGGGGGGGGGGGGGGGGGGGGGGGGGGGGGGGGGVVGGGGGGGGGGGGGGGGGGGGGGG/WWWWWWWW;GGGGGGGGGNVVo@GGGGGGGG@OVVnGGGGGGGGGGGGGGGGGGGGGGGGGGGGGGGTGTGTGGB
BGGGGTGGGGGGGGGGGGGGGGGGGGGGGGGGGGGGGGGGGGGGGGGGVVGGGGGGGGGGGGGGGGGGGGGG/WWWWWWWWWW;#GGGNVVVVVVVVVVVVVVVVVVVVVVVVVVVVVVVVVVVVVVVVVVVVVnGTGGGTGGGTGTGB
BGGGGGGGGGGGGGGGGGGGGGGGGGGGGGGGGGGGGGGGGGGGGGGGVVGGGGGGGGGGGGGGGGGGGGG/WWWW)GG======VVVVVVVVVVVVVVVVVVVVVVVVVVVVVVVVVVVVVVVVVVVVVVVVVVGGTGTGTTTGTTTB
BGGTGGGGTGTGGGGGGGGGGGGGGGGGGGG@GGGGGGGGGGGG@GGGVVGGGGGGGGGGGGGGGGGG@G/WWWW)GGGG======VVVV#GGGGGGGGGGGGGGGGVVGGGGGGGGGGGGGGGGGGGGGGGGVVGGGGGGGGGGGGGB
BGGGGGTGGGGGGGGGGGGGGGGGGGGGGGGGGGGGGGGGGGGGGGGGVVGGGGGGGGGGGGGGGGGG#/WWWW)GGGGGG(WWWWyUUUUUUUUUUUUUUUUUUUU++UUUUUUUUUUUUUUUUUUUUUUUU++UUUUUUUUUUUUUB
BGGGTGGTGTGGGGGGGGGGGGGGGGGGGGGGGGGGGGGGGGGGGGGGVVVVVVVVVVVVVVVVVVVV======GGGGGGGG(WWWWWWWWWWWWWWWWWWWWWWWW++WWWWWWWWWWWWWWWWWWWWWWWW++WWWWWWWWWWWWWB
BGGTGGTGGGGTGTGGGGGGGGGGGGGGGGGGGGGGGGGGGGGGGGGGVVVVVVVVVVVVVVVVVVV======GGGGGpGGGG(WWWWWWWWWWWWWWWWWWWWWWW++WWWWWWWWWWWWWWWWWWWWWWWW++WWWWWWWWWWWWWB
BGGGGGGGGGGGGGGGGGGGGGGGGGGGGGGGG#GGGGGGGGGGGGGGVVGGGGGGGGGGGGGGGGG@(WWWW;GGGGGGGGGGLWWWWWWWWWWWWWWWWWWWWWW++WWWWWWWWWWWWWWWWWWWWWWWW++WWWWWWWWWWWWWB
BGGGGGGGGGGGGGGGGGGGGGGGGGGGGGGGGGGGGGGGGGGGGGGGVVGGGGGGGGGGGGGGG#GGG(WWWW;GGGGGGGGGLWWWWWWWWWWWWWWWWWWWWWW++WWWWWWWWWWWWWWWWWWWWWWWW++WWWWWWWWWWWWWB
Baaaaaaaaaaaaaaaaaaa@GGGGGGGGGGGGGGGGGGGGGGGGGGGVVGGGGGGGGGGGGGGGGGGGG(WWWW;GGGGGGG/WWWWWWWWWWWWWWWWWWWWWWW++WWWWWWWWWWWWWWWWWWWWWWWW++WWWWWWWWWWWWWB
BGGGGeGGGeGGGGeGGGGAGGGGGGGGGGGGGGGGGGGGGGGSGGGGVVGGGGGGGGGGGGGGGGGGGGG(WWWW;GGGGG/WWWWzuuuuuuuuuuuuuuuuuuu++uuuuuuuuuuuuuuuuuuuuuuuu++uuuuuuZWWWWWWB
BGGeGGGGGGGGGGGGGGGAGGGGGGGGGGGGGGGGGGGGGGGG@GGGVVGGGGGGGGGGGGGGGGGGGGGG(WWWW;GGG======VnGGGGGGGGGGGGGGGGGGVVGGGGGGGGGGGGGGGGGGGGGGGGVVGGGGGGLWWWWWWB
BGGGGGeGGGGGGGGGGGGAGGGGGGGNVVVVVVVVVVVVVVVVVVVVVVGGGGGdGGGGGGGGGGGGGGGGG(WWWW;G======VVVnGGGGGGGGGGGGGGGGGVVGGGGGGGGGGGGGGGGGGGGGGGGVVGGGGGGGZuuuuuB
BGGeGGGGGGeGGGGGGGGAGGGGGGGVVVVVVVVVVVVVVVVVVVVVVoGGGGGGGGGGGGGGGG#GGGGGGG(WWWWWWWWWW)OVVVnGGGGGGGGGG@GGGGGVVGGGGGGGGGGGGGGGGGGGGGGGGVVGGGGGGQQQQQQQB
BGGGGGGGGGGGGGGGGGGAGGGGGGGVVGGGGGGGGGGGGGGGGGGGGGGGGGGGGGGGGGGGGGGGGGGGGGG(WWWWWWWW)GGOVVVnGGGGGGGGGGGGGGGVVGGGGGGGGGGGGSGGGGGGGGGGGVVGGGGGGQDDDDDDB
BGGeGGeGGGGGeGGGGGGAG@GGGGGVVGG#GGGGGGGGGGGGGGGGGGGGGGGGGGGGGGGGGGGGGGGGGGGG(WWWWWW)GGGGOVVVnGGGGGGGGGGGGGGVVGGGGGGGGGGGGGGGGGGGGGGGGVVGGGGGGQDDDDDDB
BGGGGGGGGGGGGGGGGGGAGGGGGGGVVGGGGGGGGGGGGGGGGGSGGGGGGGGGGGGGGGGGGGGGGGGGGGGGGLWWWW)GGGGGGOVVVnGGG@GGGGGSGGGVVGGGGGGGG@GGGGGGGGGGGGGGGVVGGGGGGQDDDDDDB
BGGeGGGGGGeGGGGGGGGAGGGGNVVVVGGGGGGGGGGGGGGGGGGGG@GGGGGGGGGGGGGGGGG@GGGGGGGG/WWWW)GGGGGGGGOVVVnGGGGGGGGGGGGVVGGGGGGGGGGGGGGGGGGGGGGGGVVGGGGGGQDDDDDDB
BGGGGGGGGGGGGGGGGGGAGGGGVVVVoGGG#GGGGGGGGGGGGGGGGGGGGGGGGGGGGGGGGGGGGGGGGGG/WWWW)GGGGGGGGGGOVVVnGGGGGGGGGGGVVGGGGGGGGGGGGGG@@#GGGGGGGVVGGGGGGQDDDDDDB
BaaaaaaaaaaaaaaaaaaaGGGGVVGGGGGGGGGGGGGGGGGGGGGGGGGGGGGGGGGGGGGGGGGGGGGGGG/WWWW)GGGGGGGGGGGGOVVVnGGGGG@GGGGVVGGGGGGGGGGGGGGGd@GGGGGGGVVGGGGGGQDDDDDDB
BUUUUUUUUUUUUUUUUUUUUUUU++UUUUUUUUUUUUUUUUUUUUUUUUUUUUUUUUUU++UUUUUUUUUUUYWWWWzGGGGGGGGGGGGSGOVVVnGGGGGGGGGVVGGGGGGGGGGGGGGGGGGGGGGGGVVGGGGGGQDDDDDDB
BWWWWWWWWWWWWWWWWWWWWWWW++WWWWWWWWWWWWWWWWWWWWWWWWWWWWWWWWWW++WWWWWWWWWWWWWWWWlGGGGGGGGGGGGGGGOVVVnGGGGGGGGVVGGGGGGGGGGGGGGGGGGGGGGGNVVGGGGGGQDDDDDDB
BWWWWWWWWWWWWWWWWWWWWWWW++WWWWWWWWWWWWWWWWWWWWWWWWWWWWWWWWWW++WWWWWWWWWWWWWWWW)GGGGGGGGGGGG#GGGVVVVVVVVVVVVVVGGGGGGGGGGGGSGGGGGGGGGNVVoGGGGGGQDDDDDDB
BWWWWWWWWWWWWWWWWWWWWWWW++WWWWWWWWWWWWWWWWWWWWWWWWWWWWWWWWWW++WWWWWWWWWWWWWWW)GGGGGGGGGGGGGGGGNVVVVVVVVVVVVVVGGGGGGGGGGGGGGGGGGGGGNVVoGGGGGGGQDDDDDDB
BWWWWWWWWWWWWWWWWWWWWWWW++WWWWWWWWWWWWWWWWWWWWWWWWWWWWWWWWWW++WWWWWWWWWWWWWW)GGGGGGGGGGGGGGGGNVVVoGSGGG@GGVV##GGGGG@GGGGGGGGGGGGGNVVoGGGGGGGGQDDDDDDB
Buuuuuuuuuuuuuuuuuuuuuuu++uuuuuuuuuuuuuuuuuuuuuuuuuuuuuuuuuu++uuuuuuuuuuuuuzGGGGGGGGGGGGGGGGNVVVoGGGGGGGGGVVGGGGGGGGGGGGGGGGGGGGNVVoGGGGGGGGGQDDDDDDB
BaaaaaaaaGGGGGGGGGGGGGGGVVGGGGGGGGGGGGGGGGGGGGGGGGGGGGGGGGGGVVGGGGGGGGGGGGGGGGGGGGGGGGGGGGGNVVVoGGGGGGGGGGVVVVVVVVVVVVVVVVVVVV@VVVoGGGGGGGGGGQDDDDDDB
B@@GGGGGAGGGGGGGGGGGGGGGVVGGGGGGGGGGGGGGGGGGGGGGGGGGGGGGGGGGV#GGGGGGGGGGGGGGGGGGGGGGG#GGGGNVVVoGGGGGGGGGGGOVVdVVVVVVVVVVVVVVVVVVVoGGGGGGGGGGQQDDDDDDB
B@@GGGGGaaaaaGGGGGGGGGSGVVGGGG#GGGGSGGGGGGGGGGGGGGGGSNVVVVVVVVVVVVVVVVVVVVVVVVVVVVVVVVVVVVVVVoGGGGGGGGGGGGGGGGGGGGGGGGGGGGGGGGGGGGGGGGGGGGGQQDDDDDDDB
B@@GGGGeGGGGAGGGGGGGGGGGVVnGGGGGGGGGGGGGGGGGGdGGGGGGNVVVVVVVVVVVVVVVVVVVVVVVVVVVVVVVVVVVVVVVoGGGGGGGGGGGGGGGGGGGGGGGGGGGGGGGGGGGGSGGGGGGGGQQDDDDDDDDB
B@@GGeGGGGGGaaaaaaGGGGGGOVVGGGGGGGGGGGGGGGGGGGGGGGNVVVoGGGGGGGGGGGGGGGGGGGGGGGGGGGGGGGGGGGGGGGGGGGGGGGGGGGGGGGGGGGGGGGGGGGGGGGGGGGGGGGGGGQQDDDDDDDDDB
B@@GGGGGGGGGGGGGGAGGGGGGGVVGGGGGGGGGGGGGGGGGGGGGGNVVoGGGGGGGGGGGGGG#GGGGG#GGGGGG#GGGGGGGGGGGGGGGGGGGGGGGGGGGGGGGGGGGGGGGGGGGGGGGGGGGGGGGQQDDDDDDDDDDB
B@@@eGGGGGGGGGGGGAGGGGG#GVVVVVV@VVVVVVVVVVVVVVVVVVVoGGGGGGGG#GGGGGGGGGGGGGGGGGGGGGGGGGGGGGGGGGGGGGGGGGGGGGGGGGGGGGGGGGGGGGGGGGG@GGGGGGGGQDDDDDDDDDDDB
B@@@GGGeGGGGGeGGGAGGGGGGGOVVVVVVVVVVVVVVVVVVVVVVVVoGGGGGGGGGGGGGGGGGGGGGGGGGGGGGGGGGGGGGGGGGGGGGGGGGGGGGGGGGGGGGGGGGGGGGGGGGGGGGGGGGGGGGQDDDDDDDDDDDB
B@@@eGGGGGGGGGGGGAGGGGGGGGGGGGGGGGGGGGGGGGGGGGGGGGGGGGGGGGGGGGGGGGGGGGGGGGGGGGGGGGGGGGGGGGGGGGGGGGGGGGGGGGGGGGGGGGGGGGG@GG@GGGGGGGGGGGGGQDDDDDDD$DDDB
BG@@GGGGGGGGGGGGGA@@@@@GGGGG@@@@@@@@@@@@@@@@@@@@@@@@@@@@@@@@@@@QQQQQQQQQQQQQQQQQQQQQQQQQQQQQQQQQQQQQQQQQQQQQQQQQQQQQQQQQ{}QQQQQQQQQQQQQQQDDDDDDDDDDDB
BGG@GGeGGGGeGGGGGA@@@@@@@@@@@@@@@@@@@@@@@@@@@@@@@@@@@@@@@@@@@QQDDDDDDDDDDDDDDDDDDDDDDDDDDDDDDDDDDDDDDDDDD$DDDDD$DDDDDDDDDDDDDDD$DDDDDDDDDDD$DDDDDDDDB
BGGG@@@@@@@@@@@GGAGG@@@@@@@@@@@@@@@@@@@@@@@@@@@@@@@@@@@@@@@@QQDDDDDDDDDDDDDDDDDDDDDDDDDDDDDDDDDDDDDDDDDDDDDDDDDDD$DDDDDDDDDDDDDDDDDDDDDDDDDDDDDDDDDDB
BGGGGGGGGGGGG@@@@@@@@@@@@@@@@@@@@@@@@@@@@@@@@@@@@@@@@@@@@@@QQDDDDDDDDDDDDDDDDDDDDDDDDDDDDDDDDDDDDDDDDD$DDDDDD$DDDDDDDDDDDDDDDDD$DDDDDDDDDDDDDDDDDDDDB
BGGGGGGGGGGGG@@@@@@@@@@@@@@@@@@@@@@@@@@@@@@@@@@@@@@@@@@@@@@QQDDDDDDDDDDDDDDDDDDDDDDDDDDDDDDDDDDDDDDDDD$DDDDDD$DDDDDDDDDDDDDDDDD$DDDDDDDDDDDDDDDDDDDDB
BGGGGGGGGGGGG@@@@@@@@@@@@@@@@@@@@@@@@@@@@@@@@@@@@@@@@@@@@@@QQDDDDDDDDDDDDDDDDDDDDDDDDDDDDDDDDDDDDDDDDD$DDDDDD$DDDDDDDDDDDDDDDDD$DDDDDDDDDDDDDDDDDDDDB
BGGGGGGGGGGGG@@@@@@@@@@@@@@@@@@@@@@@@@@@@@@@@@@@@@@@@@@@@@@QQDDDDDDDDDDDDDDDDDDDDDDDDDDDDDDDDDDDDDDDDD$DDDDDD$DDDDDDDDDDDDDDDDD$DDDDDDDDDDDDDDDDDDDDB
BBBBBBBBBBBBBBBBBBBBBBBBBBBBBBBBBBBBBBBBBBBBBBBBBBBBBBBBBBBBBBBBBBBBBBBBBBBBBBBBBBBBBBBBBBBBBBBBBBBBBBBBBBBBBBBBBBBBBBBBBBBBBBBBBBBBBBBBBBBBBBBBBBBBB