BCCCCCCCCCCCCCCCCCCCCCCCCCCCCCCCCCCCCCCCCCCC|WWWWWWWWWWWWWWWWWWWWWWWWWWWWWWWWWWWWWWWWWWWWWWWWWWWWWWWWWWWWTGTGGGGGGGGGGGGTGGGGGGGGGGGGGGGGGGB
BCCCCCCCCCCCCCCCCCCCCCCCCCCCCCCCCCCCCCCCCCCC|WWWWWWWWWWWWWWWWWWWWWWWWWWWWWWWWWWWWWWWWWWWWWWWWWWWWWWWWWWWTGGGTGGGGGGTGGGTGGTGGGGGTGGTGTTTTGGB
B-------|CCCCCCCCCCCCCCCCCCCCCCCCCCCCCCCCCCC|WWWWWWWWWWWWWWWWWWWWWWWWWWWWWWWWWWWWWWWWWWWWWWWWWWWWWWWWWWTGTGGGTGGGGTGGTGGGTGTGGGTGGGGTGGTTTGB
BWWWWWWW|CCCCCCCCCCCCCCCCCCCCCCCCCCCCCCCCCCC|WWWWWWWWWWWWWWWWWWWWWWWWWWWWWWWWWWWWWWWWWWWWWWWWWWWWWWWWWTGGGGGGGGGGGTGTGGGGGGGTGGGGGGGGTGTGGGB
BWWWWWWW|CCCCCCCCCCCCCCCCCCCCCCCCC|----------WWWWWWWWWWWWWWWWWWWWWWWWWWWWWWWWWWWWWWWWWWWWWWWWWWWWWWWWTGTGGGTGTGTGTTGGGGGTTGGGGTTGGGGGGGGGTTB
BWWWWWWW|CCCCCCCCCCCCCCCCCCCCCCCCC|WWWWWWWWWWWWWWWWWWWWWWWWWWWWWWWWWWWWWWWWWWWWWWWWWWWWWWWWWWWWWWWWWTGGGGGGGGGGGTGGGGTGGTGGGTGTTGTTTTTTGGTTB
BWWWWWWW|CCCCCCCCCCCCCCCCCCCCCCCCC|WWWWWWWWWWWWWWWWWWWWWWWWWWWWWWWWWWWWWWWWWWWWWWWWWWWWWWWWWWWWWWWWTGGTTGTGTTGGGGTGGGGGGGTGGGGGGGGGGGGGTTTWB
BWWWWWWW-----------|CCCCCCCCCCCCCC|WWWWWWWWWWWWWWWWWWWWWWWWWWWWWWWWWWWWWWWWWWWWWWWWWWWWWWWWWWWWWWWTGTTTTGGGGGGGGGTTTTGGGGGGGGGGGGTGTTGTTTTTB
BWWWWWWWWWWWWWWWWWW|CCCCCCCCCCCCCC|WWWuuuWWWWWWWWWWWWWWWWWWWWWWWWWWWWWWWWWWWWWWWWWWWWWWWWWWWWWWWWWTGGGGGGGGGGGGGGGGGGGGGGGGGGGGGGTTGTTGTTTTB
BWWWWWWWWWWWWWWWWWW|CCCCCCCCCCCCCC|WWWlGGuuuWWWWWWWWWWWWWWWWWWWWWWWWWWWWWWWWWWWWWWWWWWWWWWWWWWWWWTGGGGTTTTTTTTTGGGTTTTGGTTTGGGGGSGTTGTTGTTTB
BWWWWWWWWWWWWWWWWWW|CCCCCCCCCCCCCC|WWWlGGGGGuuuuuuuuLWWWWWWWWWWWWWWWWWWWWWWWWWWWWWWWWWWWWWWWWWWWTGTGGGGTGGGGGGGGGGGGTGGGGTGTGGGGGTGTTGTTGTTB
BuuuuuuuuuuuuuWWWWW|CCCCCCCCCCCCCC|WWWlGGGGGGGGGGGGGLWWWWlGGGGGGGGGGGGGGGGGGGGGGGGGGGGGGGGGGGGGGGGTTTGGGGGGGTTTTTTGTTTGTTTGGTGGGGTTGTTGTTGTB
BGGGGGGGGGGGGGuWWWW------[]--------WWWlGGGGGGGGGGGGGLWWWWlGGGGGGGGGGGGGGGGGGGGGGGGGGGGGGGGGGGGGGGGGGTTGGTTTGTGTGGGTGGGTGTGGGGTGGGGTTGTTGTTTB
BGGGGGGGGGGGGGGuWWWWWWWWW++WWWWWWWWWWuGGGGGGGVVVVVVV======VVVVVVVVVVVVVVGGGGGGGGGGGGGGGGGGGdGGGGGGGGGGTGGTGGGGGTGGGGTGGTGTGGTTTGGTGTTGTTGTTB
BGGGGGGGGGGGGGGGuuuuuuuuu++uuuuuuuuuuGGGGGGGVVVVVVVV======VVVVVVVVVVVVVVV@GGGGGGGGGGGGGGGGGGGGGGGGGGGGGGTGTGTTTTTTGTGGGGTGGGGGGTGTTGTTGTTGTB
BGGGGGGGGGGGGGGGGGGGGGGGGVVGGGGGGGGGGGGGGGGGVVGGGGGGLWWWWlGGGGGGGGGGGGGVVGGGGGGGGGGGGGGGGGGGGGGGGGGGGGGGGGTGGGGGGGGGTGGTGTTGTGGGTGTGGTTGTTTB
BGGGGGGGGGGGGGGGGGGG#GGGGVVGGGG#GGGGGGGGGGGGVVGGGGGGLWWWWlGGGGGGGGGGGGGVVGGGGGGGGGGGGGGGGGGGGGGGGGGGGGGGGGGGTGGGGGTTTTTTTTTTTGGGTTTGTGTTGTTB
BGGGGGGGGGGGGGGGSGGGGGGGGVVGGGGGGGGGGGGGGGGGVVGGGGGGLWWWWlGGGGGGGGGGGGGVVG#GGGGGGGGGGGGGGGGGG@GGGGGGGGGGGGGGGGTGGGGGTGGGGGGGGGGGGGTGTGGTTGTB
BGGGGGGGGGGGGGGGGGGGGGGGGVVGGGGGGGGGGGGGGGGGVVGGGGGGLWWWWlGGGGGGGGGGGGGVVGGGGGGGGGGGGGGGGGGGGGGGGGGGGGGGGGGGGGGGTGGGGTGTGGTGGTGGGGTGTGTGTTTB
BGGGGGGGGGGGGGGGGGGGGGGGGVVGGGGGGGGGVVVVVVVVVVGGGGGGLWWWWlGGGGGGGGGGGGGVVGGGGGGGGGGGGGGSGGGGGGGGGGGGGGGGGGGGGGGGGGTGGGGGGGGGTGGGGGTGTGGTGTTB
BGGGGGGGGGGGGGGGGGGGGGGGGVVGGGGGGGGVVVVVVVVVVGGGGGGGLWWWWlGGGGGGGGGGGGGVVGGGGGGGGGGGGGGGGGGGGGGGGGGGGGGGGGGGGGGGGG|GTGGTGTGGGGGGGTGTGTGTGGTB
BGGGGGGGGGGGGGGGGGGGGGGGGVVVVVVVVVVVVGGGGGSGGGGGGGGGLWWWWlGGGGGGGGGGGGGVVGGGGGGGGG#GGGGGGGGGGGGGGGGGGGGGGGGGGGGGGG|GGGTGTGTTTTTTTTTTGTTTTTGB
BGGGGGGGGGGGGGGGGGGGGGGGGVVVVVVVVVVGGGGGGGGGGGGGGGGGLWWWWlGGGGGGGGGGGGGVVGG@GGGGGGGGGGGGGGGGGGGGGGGGGGGGGGG@GGGGGG--<>--TGGGGGGGGGTTTGTTTTGB
BGGGGGGGGGGGGGGGGGGGGGGGGG@GGGGGVVGGGGG@GGGGGGGGGGGGLWWWWlGGGGGGGGGGGGGVVVVVVVVVVVVVVVVVVVVGGGGGGGGGGGGGGGGGGGGGGGGGGGGGTTGGGGGGTTGTTTGTTGTB
BGGGG@GGGGGGGdGGGGGGGGGGGGGGGGGGVVGGGGGGGGGGGGGGGGGGLWWWWlGGGGGGGGGGGGGVVVVVVVVVVV@VVVVVVVVVGGGGGGGGGGGGGGGGGGGGGGGGGGGGGGTGGGTTGTTGTTTGTTTB
BGGGGGGGGGGGGGGGGGGGGGGGGGGGGGGGVVGGGGGGGGGGGGGGGGGGLWWWWlGGGGGGGGGGGGGVVGGGGGGGGGGGGGGGGGVVGGGGGGGGGGGGGGGGGGGGGGGGGGGGTTGTGGTGGGGTGTGTTTTB
BGGGGGGGGGGGGGGGGGGGGGGGGGGGGGGGVVG#GGGGGGGGGGGGGGGGLWWWWlGGGGGGGGGGGGGVVGGGGGGGGGGGGGGGGGVVGGGGGGGGGGGGGGGGGGG@GGGGGGGGGTGGTTGTGGGGTGTGTTTB
BGGGGGGGGGGGGGGGGGGGGGGGGGGGGGGGVVGGGGGGGGGGGGGGGGGGLWWWWlGGGGGGGGGGGGGVVGGGGGdGGGGGGGGGGGVVGGGGGGGGGGGGGGGGGGGGGGGGGGGGTGTTTGGGGGGGGTTTGTTB
BGGGGGGGGGGGGGGGGGGGGGGGGGGGGGGGVVSGGGGGGGGGGGGGGGGGGLWWWWlGGGGGGGGGGGGVVGGGGGGGGGGGGGGGGGVVGGGGGGGSGGGGGGGGGGGGGGGGGGSGGTGGGTGGTGGGTGTTTGTB
BGGSGGGGGGGGGGGGGGGGGGGGGGGGGGGGVVGGGGGGGGGGGGGGGGGGGGLWWWWlGGGGGGGGGGGVVGGGGGGGGGGGGGGGGGVVGGGGGGGGGGGGGGGGGGGGGGGGGGGGTGTTGGTGGTGGTTGTTTGB
BGGGGGGGGGG#GGGGGGGGGGGGGGGGGGGGVVGGGGGGG@GGGGGGGGGGGGGLWWWWlGGGGGVVVVVVVGGGGGGGGGGGGGGGGGVVGGGGGGGGGGGGGGGGGGGGGGGGGGGGGTGGTTGTGTTGTTTGTTTB
BGGGGGGGGGGGGGGGGGGGGGGGGGGGGGGGVVVVVVVVVVVVVVVVVVVVVVVV======VVVVVVVVVVGGGGGGGGGGG@GGGGGGVVGGGGGGGGGGGGGGGGGGGGGGGGGGGGGTGGGTGGTGGTGTTTGTTB
BGGGGGGGGGGGGGGGGGGGGGGGGGGGGGGGGVVVVVVVVVVVVVVVVVVVVVVVV======VVVVGGGGGGGGGGGGGGGGGGGGGGGVVGGGGGGGGGGGGGGGGGGGGGGGGGGGGGGGGTGTGGTTGTGTTTGTB
BGGGGGGGGGGGGGGGGGGGGGGGG#GGGGGGGGGGGGGVVGGGGGGGGGGGGGGGGGLWWWWlGGGGGGGGGGGGGGGGGGGGGGGGGGVVGGGGGGGGGGGGGGGGGGGGGGGGGGGGGTTTGGGGGTGGTTGTTTGB
BGGGSGGGGGGGGGGGGGGGGGGGGGGGGGGGGGGGGSGVVGGGGGGGGGGGGGGGGGGLWWWWlGGGGGGGGGGGGGGGGGS#GGGGGGGVVGGGGGGGGG@GGGGGGGGGGGGGGGGGGGTTGGGTGGGGTTTGTTTB
BGGGGGGGGGGGGGGGGGGGGGGGGGGGGGGGGGGGGGGVVGGGGGGGGGGGGGGGGGGGLWWWWlGGGGGGGGGGGG@GGGGGGGGGGGGVVGGGGGGGGGGGGGGGGGGGGGGGGGGGGTGGTTTTTGGTGTTTGTTB
BGGGGGG#GGGGGGGGGGGGGGGGGGGGGGGGGGGGGG@VVGGGGGGGGGGGGGGGGGGGGLWWWWlGGGGGGGGGGGGGGGGGGGGGGGGVVGGdGGGGGGGGGGGGGGGGGGGGGGGGGGTGGTGGGGGTTGTTTGTB
BGGGGGGGGGGGGGGGGGGGGGGGGGGGGGGGGGGGGGGVVGGGGGGGGGGGGGGGGGGGGGLWWWWlGGGGGGGGGGGGGGGGGGGGGGVVVVGGGGGGGGGGGGGGGGGGGGGGGGGGGTGGGGGGGGTGGTGTTTTB
BGGGGGGGGGGGGGGGGGGGGGGGGG#GGGGGGGGGGGGVVGGGGGGGGGGGGGGGGGGGGGGLWWWWlGGGGGGGGGGGGGGGGGGGGVVGGVVGGGGGGGGGGGGGGGGGGGGGGGGGGGGTGGTGGTGGGTGGTGGB
BGGGGGGGGGGGGGGGGGGGGGGGGGGGGGGGGGGGGGGVVGGGGGGGGGGGGGGGGGGGGGGGLWWWWlGGGGGGGGGGGGSGGGGGVVGGGGVVGGGGGGGGGGGGGGGGGGGGGGGGGGGGTGGTTGGGTGGTGGTB
BGGGGGGGGGGGGGGGGGGGGGGGGGGGGGGGGGGGGGGVVGGGGGGGGGGGGGGGGGGGGGGGGLWWWWlGGGGGGGG@GGGGGGGVVGGGGGGVVGGGGGGGGGGGGGGGGGGGGGGGGGTGGTGTGGGGGGTGGTGB
BGGGGGGGGGGGGGGGGGGGGGGGGGGGGGGGGGGGGGGVVGGGGGGGGGGGGGGGGGGGGGGGGGLWWWWlGGGGGGGGGGGGGGVVGGGGGGGGVVGSGGGGGGGGGGGGGGGGGGGGGGGGGGTGGGGGTGTGTGGB
BGGGGGGGGGGGGGGGGGGGGGGGGGGGGGGGGGGGGGGVVGGGGGGGGGGGGGGGGGGGGGGGGLWWWWWWlGGGGGGGGGGGGVVGGGGGGGGGGVVGGGGGGGGGGGGGGGSGGGGGGGTGGTGTGGGGGTGGTGTB
BGGGGGGGGGGGGGGGGGGGGGGGGGGGGGGGGGGGGGGVVGGGGGGGGGGGGGGGGGGGGGGGLWWWWWWWWlGGGGGGGGGGVVG@GGGGGGGG@GVVGGGGGGGGGGGGGGGGGGGGGGGTTGGGGGGGTGTGTGGB
BGGGGGGGGGGGGGGGGGGGGGGGGGGGGGGGGGGGGGGVVGGGGGGGGGGGGGGGGGGGGGGLWWWWlLWWWWl#GGGGVVVVVVVVVVVVVVVVVVVVVVVVVVVVVVVVVVVVVVVVVVVVVGGTGGGTGGGTGTGB
BGGGGGGGGGGGGGGGGGGGGGGGGGGGGGGGGGGGGGGVVGGGGGGGGGGGGGGGGGGGGGLWWWWlGG======VVVVVVVVVVVVVVVVVVVVVVVVVVVVVVVVVVVVVVVVVVVVVVVVVVGGTGTGTTTGTTTB
BGGGGGGGGGGGGGGGGGGGGG@GGGGGGGGGGGG@GGGVVGGGGGGGGGGGGGGGGGG@GLWWWWlGGGG======VVVV#GGGGGGGGGGGGGGGGVVGGGGGGGGGGGGGGGGGGGGGGGGVVGGGGGGGGGGGGGB
BGGGGGGGGGGGGGGGGGGGGGGGGGGGGGGGGGGGGGGVVGGGGGGGGGGGGGGGGGG#LWWWWlGGGGGGLWWWWlUUUUUUUUUUUUUUUUUUUU++UUUUUUUUUUUUUUUUUUUUUUUU++UUUUUUUUUUUUUB
BGGGGGGGGGGGGGGGGGGGGGGGGGGGGGGGGGGGGGGVVVVVVVVVVVVVVVVVVVV======GGGGGGGGLWWWWWWWWWWWWWWWWWWWWWWWW++WWWWWWWWWWWWWWWWWWWWWWWW++WWWWWWWWWWWWWB
BGGGGGGGGGGGGGGGGGGGGGGGGGGGGGGGGGGGGGGVVVVVVVVVVVVVVVVVVV======GGGGGpGGGGLWWWWWWWWWWWWWWWWWWWWWWW++WWWWWWWWWWWWWWWWWWWWWWWW++WWWWWWWWWWWWWB
BGGGGGGGGGGGGGGGGGGGGGGG#GGGGGGGGGGGGGGVVGGGGGGGGGGGGGGGGG@LWWWWlGGGGGGGGGGLWWWWWWWWWWWWWWWWWWWWWW++WWWWWWWWWWWWWWWWWWWWWWWW++WWWWWWWWWWWWWB
BGGGGGGGGGGGGGGGGGGGGGGGGGGGGGGGGGGGGGGVVGGGGGGGGGGGGGGG#GGGLWWWWlGGGGGGGGLWWWWWWWWWWWWWWWWWWWWWWW++WWWWWWWWWWWWWWWWWWWWWWWW++WWWWWWWWWWWWWB
BGGGGGGGGGG@GGGGGGGGGGGGGGGGGGGGGGGGGGGVVGGGGGGGGGGGGGGGGGGGGLWWWWlGGGGGGGGWWWWWWWWWWWWWWWWWWWWWWW++WWWWWWWWWWWWWWWWWWWWWWWW++WWWWWWWWWWWWWB
BGGGGGGGGGGGGGGGGGGGGGGGGGGGGGGGGGSGGGGVVGGGGGGGGGGGGGGGGGGGGGLWWWWlGGGGGLWWWWluuuuuuuuuuuuuuuuuuu++uuuuuuuuuuuuuuuuuuuuuuuu++uuuuuuuWWWWWWB
BGGSGGGGGGGGGGGGGGGGGGGGGGGGGGGGGGG@GGGVVGGGGGGGGGGGGGGGGGGGGGGLWWWWlGGG======VGGGGGGGGGGGGGGGGGGGVVGGGGGGGGGGGGGGGGGGGGGGGGVVGGGGGGuWWWWWWB
BGGGGGGGGGGGGGGGGGGVVVVVVVVVVVVVVVVVVVVVVGGGGGdGGGGGGGGGGGGGGGGGLWWWWlU======VVVGGGGGGGGGGGGGGGGGGVVGGGGGGGGGGGGGGGGGGGGGGGGVVGGGGGGGuuuuuuB
BGGGGGGGGGGGGGGGGGVVVVVVVVVVVVVVVVVVVVVVGGGGGGGGGGGGGGGGG#GGGGGGGLWWWWWWWWWlGGVVVGGGGGGGGGGG@GGGGGVVGGGGGGGGGGGGGGGGGGGGGGGGVVGGGGGGQQQQQQQB
BGGGGGGGGGGGGGGGGGVVGGGGGGGGGGGGGGGGGGGGGGGGGGGGGGGGGGGGGGGGGGGGGGLWWWWWWWWlGGGVVVGGGGGGGGGGGGGGGGVVGGGGGGGGGGGGSGGGGGGGGGGGVVGGGGGGQDDDDDDB
BGGGGGGGGGGG@GGGGGVVGG#GGGGGGGGGGGGGGGGGGGGGGGGGGGGGGGGGGGGGGGGGGGGLWWWWWWlGGGGGVVVGGGGGGGGGGGGGGGVVGGGGGGGGGGGGGGGGGGGGGGGGVVGGGGGGQDDDDDDB
BGGGSGGGGGGGGGGGGGVVGGGGGGGGGGGGGGGGGSGGGGGGGGGGGGGGGGGGGGGGGGGGGGGGLWWWWlGGGGGGGVVVGGGG@GGGGGSGGGVVGGGGGGGG@GGGGGGGGGGGGGGGVVGGGGGGQDDDDDDB
BGGGGGGGGGGGGGGVVVVVGGGGGGGGGGGGGGGGGGGG@GGGGGGGGGGGGGGGGG@GGGGGGGGLWWWWlGGGGGGGGGVVVGGGGGGGGGGGGGVVGGGGGGGGGGGGGGGGGGGGGGGGVVGGGGGGQDDDDDDB
BGGGGGGGGGGGGGGVVVVGGGG#GGGGGGGGGGGGGGGGGGGGGGGGGGGGGGGGGGGGGGGGGGLWWWWlGGGGGGGGGGGVVVGGGGGGGGGGGGVVGGGGGGGGGGGGGG@@#GGGGGGGVVGGGGGGQDDDDDDB
BGGGGGGGGGGGGGGVVGGGGGGGGGGGGGGGGGGGGGGGGGGGGGGGGGGGGGGGGGGGGGGGGLWWWWlGGGGGGGGGGGGGVVVGGGGGG@GGGGVVGGGGGGGGGGGGGGGd@GGGGGGGVVGGGGGGQDDDDDDB
BUUUUUUUUUUUUUU++UUUUUUUUUUUUUUUUUUUUUUUUUUUUUUUUUU++UUUUUUUUUUULWWWWlGGGGGGGGGGGGSGGVVVGGGGGGGGGGVVGGGGGGGGGGGGGGGGGGGGGGGGVVGGGGGGQDDDDDDB
BWWWWWWWWWWWWWW++WWWWWWWWWWWWWWWWWWWWWWWWWWWWWWWWWW++WWWWWWWWWWWWWWWWlGGGGGGGGGGGGGGGGVVVGGGGGGGGGVVGGGGGGGGGGGGGGGGGGGGGGGVVVGGGGGGQDDDDDDB
BWWWWWWWWWWWWWW++WWWWWWWWWWWWWWWWWWWWWWWWWWWWWWWWWW++WWWWWWWWWWWWWWWWlGGGGGGGGGGGG#GGGGVVVVVVVVVVVVVGGGGGGGGGGGGSGGGGGGGGGVVVGGGGGGGQDDDDDDB
BWWWWWWWWWWWWWW++WWWWWWWWWWWWWWWWWWWWWWWWWWWWWWWWWW++WWWWWWWWWWWWWWWlGGGGGGGGGGGGGGGGGGGVVVVVVVVVVVVVGGGGGGGGGGGGGGGGGGGGVVVGGGGGGGGQDDDDDDB
BWWWWWWWWWWWWWW++WWWWWWWWWWWWWWWWWWWWWWWWWWWWWWWWWW++WWWWWWWWWWWWWWlGGGGGGGGGGGGGGGGGGGGGGSGGG@GGVV##GGGGG@GGGGGGGGGGGGGVVVGGGGGGGGGQDDDDDDB
Buuuuuuuuuuuuuu++uuuuuuuuuuuuuuuuuuuuuuuuuuuuuuuuuu++uuuuuuuuuuuuuuGGGGGGGGGGGGGGGGGGGGGGGGGGGGGGVVGGGGGGGGGGGGGGGGGGGGVVVGGGGGGGGGGQDDDDDDB
BGGGGGGGGGGGGGGVVGGGGGGGGGGGGGGGGGGGGGGGGGGGGGGGGGVVGVVVVVVVVVGGGGGGGGGGGGGGGGGGGGGGGGGGGGGGGGGGGVVGGGGGGGGGGGGGGGGGG@VVVGGGGGGGGGGGQDDDDDDB
BGGGGGGGGGGGGGGVVGGGGGGGGGGGGGGGGGGGGGGGGGGGGGGGGGVV#VVVVVVVVVVVVVVVVVVVVVVV#VVVVVVVVVVVVVVVVVVVVVVVdVVVVVVVVVVVVVVVVVVVGGGGGGGGGGGQQDDDDDDB
BGGGGGGGGGGGGSGVVGGGG#GGGGSGGGGGGGGGGGGGGGGSGGGGGGVVGGGGGGGSVVVVVVVVVVVVVVVVVVVVVVVVVVVVVVVVVVVVVVVVVVVVVVVVVVVVVVVVVVVGGGGGGGGGGGQQDDDDDDDB
BGGGGGGGGGGGGGGVVGGGGGGGGGGGGGGGGGGGdVVVVVVVVVVVVVVGGGGGGGGGGGGGGGGGGGGSGGGGGGGGGGGGGGGGGGGGGGGGGGGGGGGGGGGGGGGGGGGGGGGGSGGGGGGGGQQDDDDDDDDB
BGGGGSGGGGGGGGGVVGGGGGGGGGGGGGGGGGGGVVVVVVVVVVVVVVGGGGGGGGGGGGGGGGGGGGGGGGGGGGGGGGGGGGGGGGGGGGGGGGGGGGGGGGGGGGGGGGGGGGGGGGGGGGGGQQDDDDDDDDDB
BGGGGGGGGGGGGGGVVGGGGGGGGGGGGGGGGGGVVGGGGGGGGGGGGGGGGGGGGG#GGGGG#GGGGGG#GGGGGGGGGGGGGGGGGGGGGGGGGGGGGGGGGGGGGGGGGGGGGGGGGGGGGGGQQDDDDDDDDDDB 
BGGGGGGGGGGGGG#VVVVVVV@VVVVVVVVVVVVVGGGGGGGGGGGGGGG#GGGGGGGGGGGGGGGGGGGGGGGGGGGGGGGGGGGGGGGGGGGGGGGGGGGGGGGGGGGGGGGGGG@GGGGGGGGQDDDDDDDDDDDB
BGGGGGGGGGGGGGGVVVVVVVVVVVVVVVVVVVVGGGGGGGGGGGGGGGGGGGGGGGGGGGGGGGGGGGGGGGGGGGGGGGGGGGGGGGGGGGGGGGGGGGGGGGGGGGGGGGGGGGGGGGGGGGGQDDDDDDDDDDDB
BGGGGGGGGGGGGGGuWWWWWWWWW++WWWWWWWWWWuGGGGGGGGGGGGGG======GGGGGGGGGGGGGGGGGGGGGGGGGGGGGGGGGdGGGGGGGGGGTGGTGGGGGTGGGGTGGTGTGGTTTGGTGTTGTTGTTB
BGGGGGGGGGGGGGGGuuuuuuuuu++uuuuuuuuuuGGGGGGGGGGGGGGG======GGGGGGGGGGGGGGG@GGGGGGGGGGGGGGGGGGGGGGGGGGGGGGTGTGTTTTTTGTGGGGTGGGGGGTGTTGTTGTTGTB
BGGGGGGGGGGGGGGGGGGGGGGGGGGGGGGGGGGGGGGGGGGGGGGGGGGGLWWWWlGGGGGGGGGGGGGGSGGGGGGGGGGGGGGGGGGGGGGGGGGGGGGGGGTGGGGGGGGGTGGTGTTGTGGGTGTGGTTGTTTB
BGGGGGGGGGGGGGGGGGGG#GGGGGGGGGG#GGGGGGGGGGGGGGGGGGGGLWWWWlGGGGGGGGGGGGGGGGGGGGGGGGGGGGGGGGGGGGGGGGGGGGGGGGGGTGGGGGTTTTTTTTTTTGGGTTTGTGTTGTTB
BGGGGGGGGGGGGGGGSGGGGGGGGGGGGGGGGGGGGGGGGGGGGGGGGGGGLWWWWlGGGGGGGGGGGGGGGG#GGGGGGGGGGGGGGGGGG@GGGGGGGGGGGGGGGGTGGGGGTGGGGGGGGGGGGGTGTGGTTGTB
BGGGGGGGGGGGGGGGGGGGGGGGGGGGGGGGGGGGGGGGGGGGGGGGGGGGLWWWWlGGGGGGGGGGGGGGGGGGGGGGGGGGGGGGGGGGGGGGGGGGGGGGGGGGGGGGTGGGGTGTGGTGGTGGGGTGTGTGTTTB
BGGGGGGGGGGGGGGGGGGGGGGGGGGGGGGGGGGGGGGGGGGGGGGGGGGGLWWWWlGGGGGGGGGGGGGGGGGGGGGGGGGGGGGSGGGGGGGGGGGGGGGGGGGGGGGGGGTGGGGGGGGGTGGGGGTGTGGTGTTB
BGGGGGGGGGGGGGGGGGGGGGGGGGGGGGGGGGGGGGGGGGGGGGGGGGGGLWWWWlGGGGGGGGGGGGGGGGGGGGGGGGGGGGGGGGGGGGGGGGGGGGGGGGGGGGGGGG|GTGGTGTGGGGGGGTGTGTGTGGTB
BGGGGGGGGGGGGGGGGGGGGGGGGGGGGGGGGGGGGGGGGGSGGGGGGGGGLWWWWlGGGGGGGGGGGGGGGGGGGGGGGG#GGGGGGGGGGGGGGGGGGGGGGGGGGGGGGG|GGGTGTGTTTTTTTTTTGTTTTTGB
BGGGGGGGGGGGGGGGGGGGGGGGGGGGGGGGGGGGGGGGGGGGGGGGGGGGLWWWWlGGGGGGGGGGGGGGGGG@GGGGGGGGGGGGGGGGGGGGGGGGGGGGGGG@GGGGGG--<>--TGGGGGGGGGTTTGTTTTGB
BGGGGGGGGGGGGGGGGGGGGGGGGG@GGGGGGGGGGGG@GGGGGGGGGGGGLWWWWlGGGGGGGGGGGGGGGGGGGGGGGGGGGGGGGGGGGGGGGGGGGGGGGGGGGGGGGGGGGGGGTTGGGGGGTTGTTTGTTGTB
BGGGG@GGGGGGGdGGGGGGGGGGGGGGGGGGGGGGGGGGGGGGGGGGGGGGLWWWWlGGGGGGGGGGGGGGGGGGGGGGGG@GGGGGGGGGGGGGGGGGGGGGGGGGGGGGGGGGGGGGGGTGGGTTGTTGTTTGTTTB
BGGGGGGGGGGGGGGGGGGGGGGGGGGGGGGGGGGGGGGGGGGGGGGGGGGGLWWWWlGGGGGGGGGGGGGGGGGGGGGGGGGGGGGGGGGGGGGGGGGGGGGGGGGGGGGGGGGGGGGGTTGTGGTGGGGTGTGTTTTB
BGGGGGGGGGGGGGGGGGGGGGGGGGGGGGGGGGG#GGGGGGGGGGGGGGGGLWWWWlGGGGGGGGGGGGGGGGGGGGGGGGGGGGGGGGGGGGGGGGGGGGGGGGGGGGG@GGGGGGGGGTGGTTGTGGGGTGTGTTTB
BGGGGGGGGGGGGGGGGGGGGGGGGGGGGGGGGGGGGGGGGGGGGGGGGGGGLWWWWlGGGGGGGGGGGGGGGGGGGGdGGGGGGGGGGGGGGGGGGGGGGGGGGGGGGGGGGGGGGGGGTGTTTGGGGGGGGTTTGTTB
BGGGGGGGGGGGGGGGGGGGGGGGGGGGGGGGGGSGGGGGGGGGGGGGGGGGGLWWWWlGGGGGGGGGGGGGGGGGGGGGGGGGGGGGGGGGGGGGGGGSGGGGGGGGGGGGGGGGGGSGGTGGGTGGTGGGTGTTTGTB
BGGSGGGGGGGGGGGGGGGGGGGGGGGGGGGGGGGGGGGGGGGGGGGGGGGGGGLWWWWlGGGGGGGGGGGGGGGGGGGGGGGGGGGGGGGGGGGGGGGGGGGGGGGGGGGGGGGGGGGGTGTTGGTGGTGGTTGTTTGB
BGGGGGGGGGG#GGGGGGGGGGGGGGGGGGGGGGGGGGGGG@GGGGGGGGGGGGGLWWWWlGGGGGGGGGGGGGGGGGGGGGGGGGGGGGGGGGGGGGGGGGGGGGGGGGGGGGGGGGGGGTGGTTGTGTTGTTTGTTTB
BGGGGGGGGGGGGGGGGGGGGGGGGGGGGGGGGGGGGGGGGGGGGGGGGGGGGGGG======GGGGGGGGGGGGGGGGGGGGG@GGGGGGGGGGGGGGGGGGGGGGGGGGGGGGGGGGGGGTGGGTGGTGGTGTTTGTTB
BGGGGGGGGGGGGGGGGGGGGGGGGGGGGGGGGGGGGGGGGGGGGGGGGGGGGGGGG======GGGGGGGGGGGGGGGGGGGGGGGGGGGGGGGGGGGGGGGGGGGGGGGGGGGGGGGGGGGGGTGTGGTTGTGTTTGTB
BGGGGGGGGGGGGGGGGGGGGGGGG#GGGGGGGGGGGGGGGGGGGGGGGGGGGGGGGGLWWWWlGGGGGGGGGGGGGGGGGGGGGGGGGGGGGGGGGGGGGGGGGGGGGGGGGGGGGGGGGTTTGGGGGTGGTTGTTTGB
BGGGSGGGGGGGGGGGGGGGGGGGGGGGGGGGGGGGGSGGGGGGGGGGGGGGGGGGGGGLWWWWlGGGGGGGGGGGGGGGGGS#GGGGGGGGGGGGGGGGGG@GGGGGGGGGGGGGGGGGGGTTGGGTGGGGTTTGTTTB
BGGGGGGGGGGGGGGGGGGGGGGGGGGGGGGGGGGGGGGGGGGGGGGGGGGGGGGGGGGGLWWWWlGGGGGGGGGGGG@GGGGGGGGGGGGGGGGGGGGGGGGGGGGGGGGGGGGGGGGGGTGGTTTTTGGTGTTTGTTB
BGGGGGG#GGGGGGGGGGGGGGGGGGGGGGGGGGGGGG@GGGGGGGGGGGGGGGGGGGGGGLWWWWlGGGGGGGGGGGGGGGGGGGGGGGGGGGGdGGGGGGGGGGGGGGGGGGGGGGGGGGTGGTGGGGGTTGTTTGTB
BGGGGGGGGGGGGGGGGGGGGGGGGGGGGGGGGGGGGGGGGGGGGGGGGGGGGGGGGGGGGGLWWWWlGGGGGGGGGGGGGGGGGGGGGGGGGGGGGGGGGGGGGGGGGGGGGGGGGGGGGTGGGGGGGGTGGTGTTTTB
BGGGGGGGGGGGGGGGGGGGGGGGGG#GGGGGGGGGGGGGGGGGGGGGGGGGGGGGGGGGGGGLWWWWlGGGGGGGGGGGGGGGGGGGGGGGGGGGGGGGGGGGGGGGGGGGGGGGGGGGGGGTGGTGGTGGGTGGTGGB
BGGGGGGGGGGGGGGGGGGGGGGGGGGGGGGGGGGGGGGGGGGGGGGGGGGGGGGGGGGGGGGGLWWWWlGGGGGGGGGGGGSGGGGGGGGGGGGGGGGGGGGGGGGGGGGGGGGGGGGGGGGGTGGTTGGGTGGTGGTB
BGGGGGGGGGGGGGGGGGGGGGGGGGGGGGGGGGGGGGGGGGGGGGGGGGGGGGGGGGGGGGGGGLWWWWlGGGGGGGG@GGGGGGGGGGGGGGGGGGGGGGGGGGGGGGGGGGGGGGGGGGTGGTGTGGGGGGTGGTGB
BGGGGGGGGGGGGGGGGGGGGGGGGGGGGGGGGGGGGGGGGGGGGGGGGGGGGGGGGGGGGGGGGGLWWWWlGGGGGGGGGGGGGGGGGGGGGGGGGGGSGGGGGGGGGGGGGGGGGGGGGGGGGGTGGGGGTGTGTGGB
BGGGGGGGGGGGGGGGGGGGGGGGGGGGGGGGGGGGGGGGGGGGGGGGGGGGGGGGGGGGGGGGGLWWWWWWlGGGGGGGGGGGGGGGGGGGGGGGGGGGGGGGGGGGGGGGGGSGGGGGGGTGGTGTGGGGGTGGTGTB
BGGGGGGGGGGGGGGGGGGGGGGGGGGGGGGGGGGGGGGGGGGGGGGGGGGGGGGGGGGGGGGGLWWWWWWWWlGGGGGGGGGGGGG@GGGGGGGG@GGGGGGGGGGGGGGGGGGGGGGGGGGTTGGGGGGGTGTGTGGB
BGGGGGGGGGGGGGGGGGGGGGGGGGGGGGGGGGGGGGGGGGGGGGGGGGGGGGGGGGGGGGGLWWWWlLWWWWl#GGGGGGGGGGGGGGGGGGGGGGGGGGGGGGGGGGGGGGGGGGGGGGGGGGGTGGGTGGGTGTGB
BGGGGGGGGGGGGGGGGGGGGGGGGGGGGGGGGGGGGGGGGGGGGGGGGGGGGGGGGGGGGGLWWWWlGG======GGGGGGGGGGGGGGGGGGGGGGGGGGGGGGGGGGGGGGGGGGGGGGGGGGGGTGTGTTTGTTTB
BGGGGGGGGGGGGGGGGGGGGG@GGGGGGGGGGGG@GGGGGGGGGGGGGGGGGGGGGGG@GLWWWWlGGGG======GGGG#GGGGGGGGGGGGGGGGGGGGGGGGGGGGGGGGGGGGGGGGGGGGGGGGGGGGGGGGGB
BGGGGGGGGGGGGGGGGGGGGGGGGGGGGGGGGGGGGGGGGGGGGGGGGGGGGGGGGGG#LWWWWlGGGGGGLWWWWlUUUUUUUUUUUUUUUUUUUU++UUUUUUUUUUUUUUUUUUUUUUUU++UUUUUUUUUUUUUB
BGGGGGGGGGGGGGGGGGGGGGGGGGGGGGGGGGGGGGGGGGGGGGGGGGGGGGGGGGG======GGGGGGGGLWWWWWWWWWWWWWWWWWWWWWWWW++WWWWWWWWWWWWWWWWWWWWWWWW++WWWWWWWWWWWWWB
BGGGGGGGGGGGGGGGGGGGGGGGGGGGGGGGGGGGGGGGGGGGGGGGGGGGGGGGGG======GGGGGpGGGGLWWWWWWWWWWWWWWWWWWWWWWW++WWWWWWWWWWWWWWWWWWWWWWWW++WWWWWWWWWWWWWB
BGGGGGGGGGGGGGGGGGGGGGGG#GGGGGGGGGGGGGGGGGGGGGGGGGGGGGGGGG@LWWWWlGGGGGGGGGGLWWWWWWWWWWWWWWWWWWWWWW++WWWWWWWWWWWWWWWWWWWWWWWW++WWWWWWWWWWWWWB
BGGGGGGGGGGGGGGGGGGGGGGGGGGGGGGGGGGGGGGGGGGGGGGGGGGGGGGG#GGGLWWWWlGGGGGGGGLWWWWWWWWWWWWWWWWWWWWWWW++WWWWWWWWWWWWWWWWWWWWWWWW++WWWWWWWWWWWWWB
BGGGGGGGGGG@GGGGGGGGGGGGGGGGGGGGGGGGGGGGGGGGGGGGGGGGGGGGGGGGGLWWWWlGGGGGGGGWWWWWWWWWWWWWWWWWWWWWWW++WWWWWWWWWWWWWWWWWWWWWWWW++WWWWWWWWWWWWWB
BGGGGGGGGGGGGGGGGGGGGGGGGGGGGGGGGGSGGGGGGGGGGGGGGGGGGGGGGGGGGGLWWWWlGGGGGLWWWWluuuuuuuuuuuuuuuuuuu++uuuuuuuuuuuuuuuuuuuuuuuu++uuuuuuuWWWWWWB
BGGSGGGGGGGGGGGGGGGGGGGGGGGGGGGGGGG@GGGGGGGGGGGGGGGGGGGGGGGGGGGLWWWWlGGG======GGGGGGGGGGGGGGGGGGGGGGGGGGGGGGGGGGGGGGGGGGGGGGGGGGGGGGuWWWWWWB
BGGGGGGGGGGGGGGGGGGGGGGGGGGGGGGGGGGGGGGGGGGGGGdGGGGGGGGGGGGGGGGGLWWWWlU======GGGGGGGGGGGGGGGGGGGGGGGGGGGGGGGGGGGGGGGGGGGGGGGGGGGGGGGGuuuuuuB
BGGGGGGGGGGGGGGGGGGGGGGGGGGGGGGGGGGGGGGGGGGGGGGGGGGGGGGGG#GGGGGGGLWWWWWWWWWlGGGGGGGGGGGGGGGG@GGGGGGGGGGGGGGGGGGGGGGGGGGGGGGGGGGGGGGGQQQQQQQB
BGGGGGGGGGGGGGGGGGGGGGGGGGGGGGGGGGGGGGGGGGGGGGGGGGGGGGGGGGGGGGGGGGLWWWWWWWWlGGGGGGGGGGGGGGGGGGGGGGGGGGGGGGGGGGGGSGGGGGGGGGGGGGGGGGGGQDDDDDDB
BGGGGGGGGGGG@GGGGGGGGG#GGGGGGGGGGGGGGGGGGGGGGGGGGGGGGGGGGGGGGGGGGGGLWWWWWWlGGGGGGGGGGGGGGGGGGGGGGGGGGGGGGGGGGGGGGGGGGGGGGGGGGGGGGGGGQDDDDDDB
BGGGSGGGGGGGGGGGGGGGGGGGGGGGGGGGGGGGGSGGGGGGGGGGGGGGGGGGGGGGGGGGGGGGLWWWWlGGGGGGGGGGGGGG@GGGGGSGGGGGGGGGGGGG@GGGGGGGGGGGGGGGGGGGGGGGQDDDDDDB
BGGGGGGGGGGGGGGGGGGGGGGGGGGGGGGGGGGGGGGG@GGGGGGGGGGGGGGGGG@GGGGGGGGLWWWWlGGGGGGGGGGGGGGGGGGGGGGGGGGGGGGGGGGGGGGGGGGGGGGGGGGGGGGGGGGGQDDDDDDB
BGGGGGGGGGGGGGGGGGGGGGG#GGGGGGGGGGGGGGGGGGGGGGGGGGGGGGGGGGGGGGGGGGLWWWWlGGGGGGGGGGGGGGGGGGGGGGGGGGGGGGGGGGGGGGGGGG@@#GGGGGGGGGGGGGGGQDDDDDDB
BGGGGGGGGGGGGGGGGGGGGGGGGGGGGGGGGGGGGGGGGGGGGGGGGGGGGGGGGGGGGGGGGLWWWWlGGGGGGGGGGGGGGGGGGGGGG@GGGGGGGGGGGGGGGGGGGGGd@GGGGGGGGGGGGGGGQDDDDDDB
BUUUUUUUUUUUUUU++UUUUUUUUUUUUUUUUUUUUUUUUUUUUUUUUUU++UUUUUUUUUUULWWWWlGGGGGGGGGGGGSGGGGGGGGGGGGGGGGGGGGGGGGGGGGGGGGGGGGGGGGGGGGGGGGGQDDDDDDB
BWWWWWWWWWWWWWW++WWWWWWWWWWWWWWWWWWWWWWWWWWWWWWWWWW++WWWWWWWWWWWWWWWWlGGGGGGGGGGGGGGGGGGGGGGGGGGGGGGGGGGGGGGGGGGGGGGGGGGGGGGGGGGGGGGQDDDDDDB
BWWWWWWWWWWWWWW++WWWWWWWWWWWWWWWWWWWWWWWWWWWWWWWWWW++WWWWWWWWWWWWWWWWlGGGGGGGGGGGG#GGGGGGGGGGGGGGGGGGGGGGGGGGGGGSGGGGGGGGGGGGGGGGGGGQDDDDDDB
BWWWWWWWWWWWWWW++WWWWWWWWWWWWWWWWWWWWWWWWWWWWWWWWWW++WWWWWWWWWWWWWWWlGGGGGGGGGGGGGGGGGGGGGGGGGGGGGGGGGGGGGGGGGGGGGGGGGGGGGGGGGGGGGGGQDDDDDDB
BWWWWWWWWWWWWWW++WWWWWWWWWWWWWWWWWWWWWWWWWWWWWWWWWW++WWWWWWWWWWWWWWlGGGGGGGGGGGGGGGGGGGGGGSGGG@GGGG##GGGGG@GGGGGGGGGGGGGGGGGGGGGGGGGQDDDDDDB
Buuuuuuuuuuuuuu++uuuuuuuuuuuuuuuuuuuuuuuuuuuuuuuuuu++uuuuuuuuuuuuuuGGGGGGGGGGGGGGGGGGGGGGGGGGGGGGGGGGGGGGGGGGGGGGGGGGGGGGGGGGGGGGGGGQDDDDDDB
BGGGGGGGGGGGGGGGGGGGGGGGGGGGGGGGGGGGGGGGGGGGGGGGGGGGGGGGGGGGGGGGGGGGGGGGGGGGGGGGGGGGGGGGGGGGGGGGGGGGGGGGGGGGGGGGGGGGG@GGSGGGGGGGGGGGQDDDDDDB
BGGGGGGGGGGGGGGGGGGGGGGGGGGGGGGGGGGGGGGGGGGGGGGGGGGG#GGGGGGGGGGGGGGGGGGGGGGG#GGGGGGGGGGGGGGGGGGGGGGGdGGGGGGGGGGGGGGGGGGGGGGGGGGGGGGQQDDDDDDB
BGGGGGGGGGGGGSGGGGGGG#GGGGSGGGGGGGGGGGGGGGGSGGGGGGGGGGGGGGGSGGGGGGGGGGGGGGGGGGGGGGGGGGGGGGGGGGGGGGGGGGGGGGGGGGGGGGGGGGGGGGGGGGGGGGQQDDDDDDDB
BGGGGGGGGGGGGGGGGGGGGGGGGGGGGGGGGGGGdGGGGGGGGGGGGGGGGGGGGGGGGGGGGGGGGGGSGGGGGGGGGGGGGGGGGGGGGGGGGGGGGGGGGGGGGGGGGGGGGGGGSGGGGGGGGQQDDDDDDDDB
BGGGGSGGGGGGGGGGGGGGGGGGGGGGGGGGGGGGGGGGGGGGGGGGGGGGGGGGGGGGGGGGGGGGGGGGGGGGGGGGGGGGGGGGGGGGGGGGGGGGGGGGGGGGGGGGGGGGGGGGGGGGGGGGQQDDDDDDDDDB
BGGGGGGGGGGGGGGGGGGGGGGGGGGGGGGGGGGGGGGGGGGGGGGGGGGGGGGGGG#GGGGG#GGGGGG#GGGGGGGGGGGGGGGGGGGGGGGGGGGGGGGGGGGGGGGGGGGGGGGGGGGGGGGQQDDDDDDDDDDB
BGGGGGGGGGGGGG#GGGGGGG@GGGGGGGGGGGGGGGGGGGGGGGGGGGG#GGGGGGGGGGGGGGGGGGGGGGGGGGGGGGGGGGGGGGGGGGGGGGGGGGGGGGGGGGGGGGGGGG@GGGGGGGGQDDDDDDDDDDDB
BGGGGGGGGGGGGGGGGGGGGGGGGGGGGGGGGGGGGGGGGGGGGGGGGGGGGGGGGGGGGGGGGGGGGGGGGGGGGGGGGGGGGGGGGGGGGGGGGGGGGGGGGGGGGGGGGGGGGGGGGGGGGGGQDDDDDDDDDDDB
BGGGGGGGGGGGGGGGGGGGGGGGGGGGGGGGGGGGGGGGGGGGGGGGGGGGGGGGGGGGGGGGGGGGGGGGGGGGGGGGGGGGGGGGGGGGGGGGGGGGGGGGGGGGGG@GG@GGGGGGGGGGGGGQDDDDDDD$DDDB
BGGGGGGGGGGGGGGGGGGGGGGGGGGGGGGGGGSGGGGGGGGGGGGGGGGGGGQQQQQQQQQQQQQQQQQQQQQQQQQQQQQQQQQQQQQQQQQQQQQQQQQQQQQQQQQ{}QQQQQQQQQQQQQQQDDDDDDDDDDDB
BGGSGGGGGGGGGGGGGGGGGGGGGGGGGGGGGGGGGGGGGGGGGGGGGGGGQQDDDDDDDDDDDDDDDDDDDDDDDDDDDDDDDDDDDDDDDDDD$DDDDD$DDDDDDDDDDDDDDD$DDDDDDDDDDD$DDDDDDDDB
BGGGGGGGGGGGGGGGGGGGGGGGGGGGGGGGGGGGGGGGGGGGGGGGGGGQQDDDDDDDDDDDDDDDDDDDDDDDDDDDDDDDDDDDDDDDDDDDDDDDDDDD$DDDDDDDDDDDDDDDDDDDDDDDDDDDDDDDDDDB
BGGGGGGGGGGGGGGGGGGGGGGGGGGGGGGGGGGGGGGGGGGGGGGGGGQQDDDDDDDDDDDDDDDDDDDDDDDDDDDDDDDDDDDDDDDDD$DDDDDD$DDDDDDDDDDDDDDDDD$DDDDDDDDDDDDDDDDDDDDB
BBBBBBBBBBBBBBBBBBBBBBBBBBBBBBBBBBBBBBBBBBBBBBBBBBBBBBBBBBBBBBBBBBBBBBBBBBBBBBBBBBBBBBBBBBBBBBBBBBBBBBBBBBBBBBBBBBBBBBBBBBBBBBBBBBBBBBBBBBBB